Nick Denton	Media proprietor	7
Weldon Irvine	Essayist	0
Kosta Čavoški	Law professor	7
Alan Jones (racing driver)	Essayist	0
Stephanos Bibas	Law professor	7
George Colman the Elder	Essayist	0
Lucian Bebchuk	Law professor	7
Pat Terrell	Essayist	0
Francis Boyle	Law professor	7
John Masters	Essayist	0
Laura Caldwell	Law professor	7
Frank L. Bodine	Essayist	0
Stuart Kaye	Law professor	7
Marshall Kay	Essayist	0
Gordon Tullock	Law professor	7
Franz Allers	Essayist	0
Eric Posner	Law professor	7
Carmella Sabaugh	Essayist	0
William Tetley	Law professor	7
Afonso Dhlakama	Essayist	0
Law Chi-kwong	Law professor	7
Reggie Givens	Media proprietor	0
Stephen Farr	Music Director	7
Nils Ušakovs	Media proprietor	0
Peter Link	Music Director	7
Abdul Salaam (American football)	Media proprietor	0
Keith Falkner	Music Director	7
Danny Farquhar	Media proprietor	0
Shin-ik Hahm	Music Director	7
Homer Bush	Media proprietor	0
Sagar S (music director)	Music Director	7
Mite Kremnitz	Media proprietor	0
Peter Bay	Music Director	7
Zemgus Girgensons	Media proprietor	0
Dominique Reighard	Model	7
Nikolay Puchkov	Media proprietor	0
Nicole Linkletter	Model	7
Gary Kurfirst	Media proprietor	0
Amanda Ware	Model	7
Earl Mohan	Media proprietor	0
Jade McSorley	Model	7
Mihailo Lalić	Law professor	0
Carina Axelsson	Model	7
Hugo Sánchez	Law professor	0
Meaghan Waller	Model	7
Josh Ramsay	Law professor	0
Trish Goff	Model	7
Hank Winston	Law professor	0
Monal Gajjar	Model	7
Claude Janiak	Law professor	0
Jez Smith	Model	7
SoulJa	Law professor	0
Linsay Willier	Model	7
Andy Bishop (cyclist)	Law professor	0
Sean Murphy (racing driver)	Model	7
Zoe Gillings	Law professor	0
Mecia Simson	Model	7
Masia One	Law professor	0
Iosif Boyarsky	Model	7
Ralph Gracie	Law professor	0
Eli Holzman	Model	7
Ray Anderson (entrepreneur)	Entrepreneur	0
Carly Craig	Model	7
John Sutton (footballer)	Entrepreneur	0
Deniz Akkaya	Model	7
Luigi Sepe	Entrepreneur	0
Christopher Straub	Model	7
Yvonne Welbon	Entrepreneur	0
Enrique Palacios	Model	7
David Sun	Entrepreneur	0
Vicki Hodge	Model	7
Roelof Frankot	Entrepreneur	0
Ziggy Modeliste	Model	7
Quincy Monk	Entrepreneur	0
Jaslene Gonzalez	Model	7
Dana Spiotta	Entrepreneur	0
Claudia Cron	Model	7
Seth Boyden	Entrepreneur	0
Julien Macdonald	Model	7
John Hawken	Entrepreneur	0
Ashly Rae	Model	7
Kye Allums	Financial adviser	0
Réka Nagy (model)	Model	7
Elizabeth Hand	Financial adviser	0
Ryo Takamisaki	Warrior	7
Jenny Barazza	Financial adviser	0
Jodie Dorday	Warrior	7
Joe Soares	Financial adviser	0
Micheal Luck	Warrior	7
William Baldwin	Financial adviser	0
Bruce Turgon	Warrior	7
Master Saleem	Financial adviser	0
Greg Burke (rugby league)	Warrior	7
Claude Le Jeune	Financial adviser	0
Manu Vatuvei	Warrior	7
Le Ly Hayslip	Financial adviser	0
Amadhia Albee	Warrior	7
Howie Meeker	Financial adviser	0
Shaun Johnson	Warrior	7
Ikki Sawamura	Financial adviser	0
Erik Thomson	Warrior	7
Berton Roueché	Disc jockey	0
Jacob Lillyman	Warrior	7
Sima Lozanić	Disc jockey	0
The Silent Warrior	Warrior	7
Trevor Paglen	Disc jockey	0
Sonny Caldinez	Warrior	7
Jean-Pierre Barda	Disc jockey	0
Marcelino Sánchez	Warrior	7
John T. Harris	Disc jockey	0
Tony Kemp	Warrior	7
Eliezer ben Nathan	Disc jockey	0
Lee Tamahori	Warrior	7
Johnny Owen	Disc jockey	0
Renee O'Connor	Warrior	7
Wally Chambers	Disc jockey	0
Nathan Tipple	Warrior	7
Edward Kellett-Bowman	Disc jockey	0
Ben Matulino	Warrior	7
Kenyu Sugimoto	Disc jockey	0
Lucy Lawless	Warrior	7
Paul Frielinghaus	Music Director	0
Shrikant Wagh	Warrior	7
Rena Wang	Music Director	0
Daphne Cheung	Warrior	7
Sangita Myska	Music Director	0
The Alchemist (musician)	Alchemist	7
Ed Silch	Music Director	0
Saul Swimmer	Swimmer	7
Darren Pitcher	Music Director	0
Tasha Reign	Swimmer	7
Richard Greenberg	Music Director	0
Tony Anthony (actor)	Swimmer	7
Lefty Lorenzen	Music Director	0
Milton Diamond	Professor	7
Zhang Yang (director)	Music Director	0
Robert L. Allen	Professor	7
Kelly Vincent	Music Director	0
John Makepeace Bennett	Professor	7
Bobby Quarry	Music Director	0
Martin Kusch	Professor	7
Jody Azzouni	Orchestrator	0
George Boas	Professor	7
Kristina Arnaudova	Orchestrator	0
Dirk Brockmann	Professor	7
Gaile Lok	Orchestrator	0
Brook Byers	Professor	7
Jacob Kornbluth	Orchestrator	0
Carole Goble	Professor	7
Dave LaRoche	Orchestrator	0
Andrew Appel	Professor	7
Emil Haberer	Orchestrator	0
Evgeny Paton	Professor	7
Frank Pittman	Orchestrator	0
Wilhelm Keim	Professor	7
Abel Huntington	Orchestrator	0
Jan Arnoldus Schouten	Professor	7
Gustaf von Numers (writer)	Orchestrator	0
Herbert S. Gutowsky	Professor	7
Howard Caine	Orchestrator	0
Ashraf Huseynov	Professor	7
Steve Clemente	Model	0
Esther Duflo	Professor	7
Matthew Caws	Model	0
T. Nadaraja	Professor	7
Don January	Model	0
Brian Wynne	Professor	7
Abelardo Escobar Prieto	Model	0
Stephen Schneider	Professor	7
James Douglas (businessman)	Model	0
Arthur Grosser	Professor	7
Melanie Shatner	Model	0
Ram Deo Bhandary	Professor	7
Rubén Limardo	Model	0
Harold Kerzner	Professor	7
Virgil Trucks	Model	0
Dan Krewski	Professor	7
Nathan Thrall	Model	0
Albert Neuberger	Professor	7
Mithun Manhas	Model	0
Henry Jacob Bigelow	Professor	7
Dominique Tricaud	Warrior	0
Edward Soja	Professor	7
Anna Thistle	Warrior	0
Ludmilla Jordanova	Professor	7
Mathias Sommerhielm	Warrior	0
Bernard Redmont	Professor	7
Carlos Correia	Warrior	0
Mary James (educator)	Professor	7
Mary Susanne Edgar	Warrior	0
Jack Halpern (chemist)	Professor	7
Tony Rossi (baseball)	Warrior	0
Andres Kasekamp	Professor	7
David Coltart	Warrior	0
Alvin Goldman	Professor	7
Aung San Oo	Warrior	0
John Searle	Professor	7
Marlice van Vuuren	Warrior	0
John Dittmer	Professor	7
Kullo Must	Warrior	0
Hans Christian von Baeyer	Professor	7
Henry Kitchell Webster	Alchemist	0
Professor Jay	Professor	7
Pat Dubar	Alchemist	0
Lester G. Telser	Professor	7
Lubomír Doležel	Alchemist	0
Mike Archer (paleontologist)	Professor	7
Marina Georgieva-Nikolova	Alchemist	0
Ralph James Mooney	Professor	7
Jim Galley	Alchemist	0
Mihalis Yannakakis	Professor	7
Ezra G. Levin	Alchemist	0
Gerardus Heymans	Professor	7
Tony Ianzelo	Alchemist	0
Saba Valadkhan	Professor	7
Vyacheslav Butusov	Alchemist	0
Joshua King	Professor	7
Frithjof Kleen	Alchemist	0
Clarence Ellis (computer scientist)	Professor	7
Clubroot (musician)	Alchemist	0
Henrik I. Christensen	Professor	7
Jesse Rivest	Drummer	0
Walker Connor	Professor	7
Ichiro Yoshizawa	Drummer	0
Andrew Blake (scientist)	Professor	7
Kostas Martakis	Drummer	0
James Como	Professor	7
Tom Makowski	Drummer	0
David Syrett	Professor	7
Ernie Tuck	Drummer	0
Dana Scott	Professor	7
World B. Free	Drummer	0
Alan Fersht	Professor	7
Marc Sullivan	Drummer	0
Joseph Tobin	Professor	7
Peter Verigin	Drummer	0
Teng Wei-Zao	Professor	7
Åke Rusck	Drummer	0
Kristin Mayes	Professor	7
John Dix Fisher	Drummer	0
Kim S. Cameron	Professor	7
Viorel Moldovan	Swimmer	0
Paul Steinhardt	Professor	7
Lisa Miller (journalist)	Swimmer	0
Leonard Parker	Professor	7
C. Aubrey Smith	Swimmer	0
Ian G. Enting	Professor	7
Francis Kalnay	Swimmer	0
François Diederich	Professor	7
John Valentin	Swimmer	0
Ian Shapiro	Professor	7
John Armfield	Swimmer	0
Alan E. Kazdin	Professor	7
Samer al-Masry	Swimmer	0
Kent Bach	Professor	7
Scott Clark (BMX rider)	Swimmer	0
John Wolff	Professor	7
Melvyn Rubenfire	Swimmer	0
Charles Derber	Professor	7
Sadiq Hussain Qureshi	Swimmer	0
Harry Peeters	Professor	7
Isaiah Ekejiuba	Organist	0
Hans Henrik Andersen	Professor	7
Indradasa Hettiarachchi	Organist	0
Simon S. Lam	Professor	7
Senait Ashenafi	Organist	0
Stanley Norman Cohen	Professor	7
Nora Eddington	Organist	0
Erskine Clarke	Professor	7
Lincoln Chase	Organist	0
Anne Fernald	Professor	7
Pinkas Braun	Organist	0
Mackubin Thomas Owens	Professor	7
Liliana Castro	Organist	0
Marek Rocki	Professor	7
Walter Gilbey (politician)	Organist	0
Gordon McVie	Professor	7
Jerónimo de Arbolanche	Organist	0
Samir Mitragotri	Professor	7
Pat Dougherty	Organist	0
Jeremy King	Professor	7
Luke Douglas	Professor	0
Melvin Dixon	Professor	7
Brent Schaeffer	Professor	0
Carl Elliott (philosopher)	Professor	7
Ernests Blanks	Professor	0
Harryette Mullen	Professor	7
Debi Doss	Professor	0
Dan Slobin	Professor	7
Lil Wayne	Professor	0
Jacquelyn Dowd Hall	Professor	7
Ryuji Yamane	Professor	0
Muhammad Suhail Zubairy	Professor	7
Jason Bourgeois	Professor	0
Robert Michels (physician)	Professor	7
Rudolf Müller (bishop)	Professor	0
Brian Knutson	Professor	7
Wolfe Morris	Professor	0
Robert Stoller	Professor	7
Kenneth Fisher (educationalist)	Professor	0
Harold J. Grimm	Professor	7
George Willis (Medal of Honor)	Violist	0
Richard K. Guy	Professor	7
Marianne de Pierres	Violist	0
Qiang Du	Professor	7
Piper Kerman	Violist	0
Sally Falk Moore	Professor	7
Sheri Moon Zombie	Violist	0
Larry Torres	Professor	7
Baayork Lee	Violist	0
Ivan Hrynokh	Professor	7
Valaida Snow	Violist	0
William C. Davis (historian)	Professor	7
Michel Hénon	Violist	0
George Brock (journalist)	Professor	7
Faty Papy	Violist	0
William Ennis Thomson	Professor	7
Fraser Forster	Violist	0
John Tedder, 2nd Baron Tedder	Professor	7
Thane Houser	Violist	0
Michael Thrasher	Professor	7
Stanley Bing	Humorist	0
Theo Colborn	Professor	7
A. Ross Eckler	Humorist	0
Richard P. McCormick	Professor	7
Bruce Lusignan	Humorist	0
Ian Fells	Professor	7
Knud Degn	Humorist	0
Glanville Williams	Professor	7
Mario Duplantier	Humorist	0
Jean-Michel Bismut	Professor	7
John Henry Kinealy	Humorist	0
John Curtice	Professor	7
Ronnie Golden	Humorist	0
Stephanie Kaza	Professor	7
Fritz Rehn	Humorist	0
Michael Billig	Professor	7
John Hughes (art director)	Humorist	0
Gary Taylor (scholar)	Professor	7
David Wexler (director)	Humorist	0
Paul M. Doty	Professor	7
Elgin Lessley	Historian	0
Leonard Hodgson	Professor	7
Martin Haskell	Historian	0
Maxine Hong Kingston	Professor	7
Michael Robinson (fullback)	Historian	0
Daniel G. Nocera	Professor	7
Ben Lovett	Historian	0
Erik Borgman	Professor	7
Markus Günthardt	Historian	0
Gordon Guyatt	Professor	7
Shaun Bailey	Historian	0
Bahram Akasheh	Professor	7
Alan Weinstein	Historian	0
Henry Rapoport	Professor	7
Alan Tilvern	Historian	0
Hellmuth Stachel	Professor	7
Christopher Fifield	Historian	0
Lincoln Stein	Professor	7
Avi Gopher	Historian	0
Hermione Lee	Professor	7
Lena Schöneborn	Dancer	0
John Henry Holland	Professor	7
Preetu Nair	Dancer	0
Tommie Shelby	Professor	7
Angelika Schrobsdorff	Dancer	0
John Stuart Anderson	Professor	7
Herb Adderley	Dancer	0
Jerrold R. Zacharias	Professor	7
David Conover	Dancer	0
Grady Mathews	Professor	7
Tommy Cassidy	Dancer	0
Georges Khabbaz	Professor	7
Roberto Contreras	Dancer	0
Jessica Meir	Professor	7
Salva Ballesta	Dancer	0
Richard L. Meier	Professor	7
Mariko Takahashi (singer)	Dancer	0
David Montgomery (historian)	Professor	7
Solomon Nikritin	Dancer	0
John Struthers (anatomist)	Professor	7
Chetan Shashital	Multi-instrumentalist	0
Dinesh Manocha	Professor	7
Dan Issel	Multi-instrumentalist	0
Frithjof Bergmann	Professor	7
Michael Richards	Multi-instrumentalist	0
İhsan Doğramacı	Professor	7
Tin Kai-man	Multi-instrumentalist	0
Gerald Russell	Professor	7
Marcel van Dam	Multi-instrumentalist	0
Jerry B. Lincecum	Professor	7
Udo Kier	Multi-instrumentalist	0
George Lusztig	Professor	7
Liselott Hagberg	Multi-instrumentalist	0
Frank Close	Professor	7
Jadwiga Staniszkis	Multi-instrumentalist	0
Hanna Gronkiewicz-Waltz	Professor	7
Mark Wakeling	Multi-instrumentalist	0
Diana Liverman	Professor	7
Oliver Popplewell	Multi-instrumentalist	0
Peter Amollo Odhiambo	Professor	7
Sandrine Pinna	Lawyer	0
Philip D. Curtin	Professor	7
Assani Lukimya-Mulongoti	Lawyer	0
Nick McCave	Professor	7
Vladimir Chub	Lawyer	0
Frederick K. Goodwin	Professor	7
Petr Koukal (badminton)	Lawyer	0
Robin Murray	Professor	7
Chris Waterman	Lawyer	0
John Burn (geneticist)	Professor	7
Walt Handelsman	Lawyer	0
Ken Freeman (astronomer)	Professor	7
Stanislav Ježek	Lawyer	0
Claudia Goldin	Professor	7
Bert Bergsma	Lawyer	0
Mary Kaldor	Professor	7
Tadeusz Tański	Lawyer	0
Richard Soderberg	Professor	7
Carmine Tramunti	Lawyer	0
Robert Moloney	Professor	7
James Newton Howard	Psychologist	0
Debora Hammond	Professor	7
Rolf Lacour	Psychologist	0
T. H. Laby	Professor	7
Vanessa Pose	Psychologist	0
Ramsay MacMullen	Professor	7
Aquileo J. Echeverría	Psychologist	0
John Lowden	Professor	7
François-Emmanuel Guignard, comte de Saint-Priest	Psychologist	0
Paul Glendinning	Professor	7
P.C. Lalhlimthara	Psychologist	0
Susan Haack	Professor	7
Jean-Luc Bilodeau	Psychologist	0
John Dainton	Professor	7
Alexander C. M. Pennington	Psychologist	0
Aharon Barak	Professor	7
Jon Ritchie	Psychologist	0
Joseph French Johnson	Professor	7
Colin Jeavons	Psychologist	0
Holmes Rolston III	Professor	7
Artem Vasylenko	Film Score Composer	0
Leo Bersani	Professor	7
Nils Ericson	Film Score Composer	0
Jesse Beery	Professor	7
Eddie Castro (jockey)	Film Score Composer	0
Richard Austin (conductor)	Professor	7
Washington Allston	Film Score Composer	0
Franklin Allen	Professor	7
Ray Mueller	Film Score Composer	0
Wayne Flynt	Professor	7
Darren Pitcher	Film Score Composer	0
Michele Dougherty	Professor	7
Larry Burkett	Film Score Composer	0
Tony Turner (scientist)	Professor	7
Leo Lastimosa	Film Score Composer	0
Donald Neuen	Professor	7
Armin Falk	Film Score Composer	0
Alasdair Urquhart	Professor	7
Robin Selvig	Film Score Composer	0
Bronisław Geremek	Professor	7
Hilary Barta	Poet	0
Paul Schmitthenner	Professor	7
Shelby Storck	Poet	0
Richard Bentall	Professor	7
Phil Hancock	Poet	0
Jonathan Fisher (barrister)	Professor	7
Travis Lee	Poet	0
John Anderson (philosopher)	Professor	7
Paul Siebert	Poet	0
Rudolf Makkreel	Professor	7
Annelies Cook	Poet	0
Rafael Calvo Serer	Professor	7
Steven Tsuchida	Poet	0
Daina Taimina	Professor	7
Amit Paunikar	Poet	0
Sebastian Harnisch	Professor	7
David Alaba	Poet	0
Mary S. Morgan	Professor	7
Giuseppe Puini	Poet	0
David Orme Masson	Professor	7
Jimmy Giuffre	Police officer	0
Tom Campbell (California politician)	Professor	7
Kent C. Berridge	Police officer	0
Steven Marsh (geneticist)	Professor	7
Yocheved Bat-Miriam	Police officer	0
John Christian Bailar	Professor	7
Simon Gärdenfors	Police officer	0
Charles Royster	Professor	7
Keith Gretzky	Police officer	0
Chao Tang	Professor	7
Ralph Earnhardt	Police officer	0
Scott Plous	Professor	7
Horatio Luro	Police officer	0
Joseph Wright (linguist)	Professor	7
Yvonne Chouteau	Police officer	0
Billy Goldberg	Professor	7
Oliver Seraphin	Police officer	0
Veena Talwar Oldenburg	Professor	7
Dan Flavin	Police officer	0
Jean-Marc Jézéquel	Professor	7
Jim McKnight	Cantor	0
David McNally (professor)	Professor	7
Hans Henrik Reusch	Cantor	0
Fernando María Castiella y Maíz	Professor	7
Herbert Menges	Cantor	0
Giacomo Bernardi	Professor	7
Supardi Nasir	Cantor	0
Sheldon H. Harris	Professor	7
Ante Kovačić	Cantor	0
Bernard Cohen (physicist)	Professor	7
Aaron Whitchurch	Cantor	0
Matt Visser	Professor	7
Marissa Moss	Cantor	0
William Jelani Cobb	Professor	7
Lou Lamoriello	Cantor	0
Nina Byers	Professor	7
Nolan Godfrey	Cantor	0
Iraj Bashiri	Professor	7
Miel de Botton	Cantor	0
Brett Leighton	Professor	7
Raül López	Statesman	0
Karl E. Case	Professor	7
David Abram	Statesman	0
William Adam (trumpeter)	Professor	7
Elena Korikova	Statesman	0
Cynthia Breazeal	Professor	7
Padmamagan	Statesman	0
Ted Honderich	Professor	7
Besedka Johnson	Statesman	0
Harry Bolton Seed	Professor	7
Louisiana Red	Statesman	0
Pierre Ramond	Professor	7
César Pelli	Statesman	0
Gershon Galil	Professor	7
Maggie McNamara	Statesman	0
Ian Ramsay	Professor	7
William Halfpenny	Statesman	0
William Fyfe	Professor	7
Terry Cameron	Statesman	0
Ersin Kalaycıoğlu	Professor	7
Rex Rienits	Television Producer	0
Mike Stott	Professor	7
David Cunningham (bishop)	Television Producer	0
Colin Stansfield Smith	Professor	7
E-A-Ski	Television Producer	0
John M. Ball	Professor	7
Quincy Wright	Television Producer	0
Zvi Bodie	Professor	7
Roy Henry Vickers	Television Producer	0
Paola Sebastiani	Professor	7
Irina Dunn	Television Producer	0
Sheila Widnall	Professor	7
Robert Empie Rogers	Television Producer	0
Per Aunet	Professor	7
Jaromír Štětina	Television Producer	0
Norman Stone	Professor	7
Christian Winther	Television Producer	0
Charles Harbutt	Professor	7
Texas Gladden	Television Producer	0
Denis Pelli	Professor	7
Jonas Earll, Jr.	Film Producer	0
Axel Murswieck	Professor	7
Va'ai Kolone	Film Producer	0
Norbert Schwarz	Professor	7
Syed Mokhtar Al-Bukhary	Film Producer	0
David Masser	Professor	7
Caroline Love Goodwin O'Day	Film Producer	0
David Held	Professor	7
Lydie Polfer	Film Producer	0
Karl Rubin	Professor	7
Doug Maxwell	Film Producer	0
Jaroslav Vanek	Professor	7
Jeff Barry	Film Producer	0
Jeff Eppinger	Professor	7
George Benjamin (composer)	Film Producer	0
Kevin P. Clements	Professor	7
Cyrena van Gordon	Film Producer	0
Leon Mestel	Professor	7
Attahiru Bafarawa	Film Producer	0
Peter Stoner	Professor	7
Jae Chong	Fighter pilot	0
Wang Zhenyi	Professor	7
Tim Wright (musician)	Fighter pilot	0
Tim Lenton	Professor	7
Benjamin Dean Meritt	Fighter pilot	0
Alexander Gray (poet)	Professor	7
Douglas Hogg	Fighter pilot	0
Subrata K. Mitra	Professor	7
Jim McDermott	Fighter pilot	0
Maria Fadiman	Professor	7
Jeffrey W. Byrd	Fighter pilot	0
Michael Harloe	Professor	7
Severin von Eckardstein	Fighter pilot	0
Robion Kirby	Professor	7
Philip Cohen (British biochemist)	Fighter pilot	0
Juliet Schor	Professor	7
Jarosław Duda	Fighter pilot	0
Torbjørn Digernes	Professor	7
Stephen J. Luczo	Fighter pilot	0
Frank McGuinness	Professor	7
H. A. Baker	Librarian	0
Evelyn Haas	Professor	7
Art Shell	Librarian	0
Lyndhurst Giblin	Professor	7
Miha Valič	Librarian	0
Allan Borodin	Professor	7
Ned Williamson	Librarian	0
Javier Santiso	Professor	7
Kemal Unakıtan	Librarian	0
Drew Endy	Professor	7
Ekaterina Klimova	Librarian	0
John Neulinger	Professor	7
Joseph-Ernest Grégoire	Librarian	0
Stephen Brewster	Professor	7
Harry Patch	Librarian	0
Robert Stickgold	Professor	7
Michael Welch (actor)	Librarian	0
Hagen Kleinert	Professor	7
Tim Howard (attorney)	Librarian	0
George Yip	Professor	7
Francisco de Hoces	TV Editor	0
Joseph Sung	Professor	7
Robert Beckett	TV Editor	0
Brian Goodwin	Professor	7
Willy Vlautin	TV Editor	0
William Wallace (philosopher)	Professor	7
Iztok Mlakar	TV Editor	0
Mark Ravina	Professor	7
S. Pierre Yameogo	TV Editor	0
Terry Sejnowski	Professor	7
Terdell Sands	TV Editor	0
Jon Blundy	Professor	7
David ben Judah Messer Leon	TV Editor	0
Alfred A. Marcus	Professor	7
Jim Fannon	TV Editor	0
Benno Ndulu	Professor	7
Jeff Pilson	TV Editor	0
Riyaz Punjabi	Professor	7
Maria Dąbrowska	TV Editor	0
Hu Ning	Professor	7
Bernie Kopell	Production designer	0
Robert Black (lawyer)	Professor	7
Earl Watford	Production designer	0
Stephen Haseler	Professor	7
Caroline Calvé	Production designer	0
Daniel Jurafsky	Professor	7
Robert Collis	Production designer	0
Michael Drew	Professor	7
Richie Patterson	Production designer	0
Douglas Davies	Professor	7
Bessie Tucker	Production designer	0
Michel Che	Professor	7
Burkhard Dallwitz	Production designer	0
Gail Lee Bernstein	Professor	7
Sun Nan	Production designer	0
Roger Wallis	Professor	7
Georgia Schmidt	Production designer	0
Michael Jaffé	Professor	7
John Tronolone	Production designer	0
Elliot Turiel	Professor	7
Daniel Duncan McKenzie	Librettist	0
Stanford E. Woosley	Professor	7
Christos Tsigiridis	Librettist	0
Deborah Doniach	Professor	7
Yasmin Paige	Librettist	0
Stanley Rosen	Professor	7
George Biondo	Librettist	0
H. Eugene Stanley	Professor	7
Adolph Peter Adler	Librettist	0
David Daokui Li	Professor	7
Ralph Northam	Librettist	0
Laura Otis	Professor	7
Carl B. Allendoerfer	Librettist	0
Marshall Fixman	Professor	7
J. C. Ramírez	Librettist	0
Julie Roy Jeffrey	Professor	7
Ewan McGregor	Librettist	0
Fred Hilmer	Professor	7
Pierre David-Weill	Librettist	0
Timothy M. Chan	Professor	7
Mark Mazower	Singer-songwriter	0
Johannes Jacobus Poortman	Professor	7
Addison Teague	Singer-songwriter	0
Derek John Blundell	Professor	7
Melissa Hoskins	Singer-songwriter	0
Frank Cameron Jackson	Professor	7
Djené Dakonam	Singer-songwriter	0
Elizabeth Anionwu	Professor	7
Mark Powell (photographer)	Singer-songwriter	0
Thomas A. Steitz	Professor	7
Lori Petty	Singer-songwriter	0
Louis Guttman	Professor	7
Gunnar Olsson (actor)	Singer-songwriter	0
Tara Brabazon	Professor	7
Gaius Julius Hyginus	Singer-songwriter	0
David Premack	Professor	7
Abu 'Afak	Singer-songwriter	0
Olaf Karthaus	Professor	7
Philip Anschutz	Singer-songwriter	0
Patricia Sawin	Professor	7
Hussein Sulaimani	Announcer	0
Alan Walters	Professor	7
Richard Stoltzman	Announcer	0
Vytautas Landsbergis	Professor	7
Drew Hodgdon	Announcer	0
Kim Swales	Professor	7
Gert Metz	Announcer	0
Loet Leydesdorff	Professor	7
Craig Brockman	Announcer	0
Rebecca J. Scott	Professor	7
Bill Sheridan	Announcer	0
Judith Stacey	Professor	7
Joseph M. Terrell	Announcer	0
Peggy Levitt	Professor	7
Gary Beach	Announcer	0
J. J. C. Smart	Professor	7
Frank Ballance	Announcer	0
Stefan Buczacki	Professor	7
Ben Doller	Announcer	0
Gregory Possehl	Professor	7
Rickey Paulding	Songwriter	0
Merab Mamardashvili	Professor	7
Julian Hunte	Songwriter	0
Gilbert Baumslag	Professor	7
Momčilo Bajagić	Songwriter	0
Martin Hall (academic)	Professor	7
George Gerberman	Songwriter	0
Thomas M. Davis	Professor	7
Ferdinand Kingsley	Songwriter	0
Adam Wierman	Professor	7
Clifton C. Garvin	Songwriter	0
Douglas Gough	Professor	7
Gary Cady	Songwriter	0
Ingeman Arbnor	Professor	7
Frank J. Urioste	Songwriter	0
Jane Kamensky	Professor	7
Vera Karmishina-Ganeeva	Songwriter	0
Louise Weinberg	Professor	7
Andreas Krystallis	Songwriter	0
Sarah Spiegel	Professor	7
Lu Gwei-djen	Coach	0
Scott Reynolds Nelson	Professor	7
Simon Barker	Coach	0
Roland Carl Backhouse	Professor	7
Ivan Maximov	Coach	0
Ian Robertson (psychologist)	Professor	7
Albert Harris (composer)	Coach	0
Sid Watkins	Professor	7
Alfred Kazin	Coach	0
Lynda Gratton	Professor	7
Toshiyuki Toyonaga	Coach	0
Gunther Kress	Professor	7
Marcelino Teodoro	Coach	0
Donald Livingston	Professor	7
Stefany Hernandez	Coach	0
Graham Budd	Professor	7
William Lyne	Coach	0
Neil F. Johnson	Professor	7
Chris Boyle	Coach	0
Shirley Heath	Professor	7
Tom Stephan	Botanist	0
Mikhail Volkenshtein	Professor	7
Alex Ross (music critic)	Botanist	0
Marc Bekoff	Professor	7
Joan Larkin	Botanist	0
Eric F. Goldman	Professor	7
Rachel Messerer	Botanist	0
Cyril Foray	Professor	7
Susana Dosamantes	Botanist	0
Gene Grossman	Professor	7
Clara Maass	Botanist	0
Robert H. Frank	Professor	7
Sumon K Chakrabarti	Botanist	0
Leon Sterling	Professor	7
Ferenc Reitter	Botanist	0
David Mabberley	Professor	7
Tom Vaughan-Lawlor	Botanist	0
Robert A. Alberty	Professor	7
Ofelia Cano	Botanist	0
Joel Mandelstam	Professor	7
David Slack	Pastor	0
Bertil Holmlund	Professor	7
David Wills (singer)	Pastor	0
Partha Ghose	Professor	7
Todd G. Buchholz	Pastor	0
Brian Weatherson	Professor	7
Edward Knapp-Fisher	Pastor	0
Steven Rose	Professor	7
Sinjin Smith	Pastor	0
Richard Eastell	Professor	7
Santino Fontana	Pastor	0
Thomas Diez	Professor	7
Celeste Headlee	Pastor	0
Robert Bartnik	Professor	7
Cécile de France	Pastor	0
Anindya Sen	Professor	7
Thomas E. Murray	Pastor	0
Sheldon Brown (artist)	Professor	7
Katty Piejos	Pastor	0
Norman Christ	Professor	7
Sandro Munari	Orator	0
Robin Boast	Professor	7
George Carl	Orator	0
Shan Ratnam	Professor	7
Tom Sancton	Orator	0
James Cordy	Professor	7
Michele Pazienza	Orator	0
Robert Trivers	Professor	7
Horacio Altuna	Orator	0
Michael Howard (historian)	Professor	7
William Martin Nygaard	Orator	0
Robert M. Townsend	Professor	7
Lenard Lakofka	Orator	0
Charles Sandbank	Professor	7
Robinson Savary	Orator	0
David Collier (political scientist)	Professor	7
Yvonne Van Bets	Orator	0
Ronald C. Arkin	Professor	7
Christopher Forbes	Orator	0
Daniel Kammen	Professor	7
Edolphus Towns	Cartoonist	0
Alastair Mullis	Professor	7
Anna Anka	Cartoonist	0
David Cockayne	Professor	7
Alusine Kamara	Cartoonist	0
Anthony Grafton	Professor	7
Alexandre Azaria	Cartoonist	0
Jonathan Mestel	Professor	7
Paula Barbieri	Cartoonist	0
Eric Lander	Professor	7
Marc Bloch	Cartoonist	0
Gürer Aykal	Professor	7
Mads Rasmussen	Cartoonist	0
Peter Sherwood	Professor	7
Christophe Moulin (television presenter)	Cartoonist	0
Wendy Hall	Professor	7
Joseph Krumgold	Cartoonist	0
Maria Darling	Professor	7
David Eddings	Cartoonist	0
William Smyth (historian)	Professor	7
Ira Chernus	Music Arranger	0
Alfred Kröner	Professor	7
Thurston Clarke	Music Arranger	0
Andrew Jakubowicz	Professor	7
William Cumberland Cruikshank	Music Arranger	0
Gerald Shapiro (writer)	Professor	7
Woo Bih Li	Music Arranger	0
Xavier Gabaix	Professor	7
Shirley Booth	Music Arranger	0
Clayton Heathcock	Professor	7
Al Gordon (racing driver)	Music Arranger	0
David Pearce (economist)	Professor	7
Peter R. Kann	Music Arranger	0
George Wilson (chemist)	Professor	7
Philipp Hainhofer	Music Arranger	0
Philip Nel	Professor	7
James L. Kinsey	Music Arranger	0
Margaret Mills	Professor	7
Mike MacIntosh	Music Arranger	0
Wan Chun Cheng	Professor	7
Salva Sevilla	Film Art Director	0
Darrell Duffie	Professor	7
Kia Davis	Film Art Director	0
Harry Mairson	Professor	7
William L. Hendricks	Film Art Director	0
Norman H. Anderson	Professor	7
Rajani Kanta Patir	Film Art Director	0
Samuel McLaren	Professor	7
Francesco Florimo	Film Art Director	0
Andrew Linklater	Professor	7
Harry Holiday	Film Art Director	0
William Uricchio	Professor	7
Dana P. Rowe	Film Art Director	0
Jan De Maeseneer	Professor	7
Aja Kong	Film Art Director	0
August Musger	Professor	7
Shinji Okazaki	Film Art Director	0
Marjorie Housepian Dobkin	Professor	7
James Bone (journalist)	Film Art Director	0
Ernst Fehr	Professor	7
Frank Watkins (musician)	Carpenter	0
Glenn Reynolds	Professor	7
Barbara Boyd	Carpenter	0
Arlie Petters	Professor	7
Allan Sloan	Carpenter	0
Saul David	Professor	7
Timothy D. Murphy	Carpenter	0
Harry Steenbock	Professor	7
Tracy Vilar	Carpenter	0
Nechama Tec	Professor	7
Richard Tait	Carpenter	0
Neil Carter (political scientist)	Professor	7
Didier Pittet	Carpenter	0
Menachem Elon	Professor	7
Shawn Mullins	Carpenter	0
Paul Moravec	Professor	7
Tally Koren	Carpenter	0
Christopher Rowe	Professor	7
Lorelei Shannon	Carpenter	0
Chris Freeman (scientist)	Professor	7
Otto Suhr	Activist	0
Richard Bissill	Professor	7
Enrico Rava	Activist	0
Judy Troy	Professor	7
Saawan Kumar Tak	Activist	0
Harold Temperley	Professor	7
Joel Greenblatt	Activist	0
David Sosa	Professor	7
Charley Rogers	Activist	0
Sumantra Bose	Professor	7
Mario Montenegro	Activist	0
František Kahuda	Professor	7
Stephen Ross, Baron Ross of Newport	Activist	0
William Cumin (obstetrician)	Professor	7
Nayo Wallace	Activist	0
James Watson (trumpeter)	Professor	7
Johann Melchior Roos	Activist	0
R. Kesavan Nair	Professor	7
Gerald Kaufman	Activist	0
Norman Itzkowitz	Professor	7
Marjorie Heins	Insurance Broker	0
Jimmy Edwards	Professor	7
Manish Pandey	Insurance Broker	0
Edith Hall	Professor	7
Mark Mangini	Insurance Broker	0
Sugata Mitra	Professor	7
Ianka Fleerackers	Insurance Broker	0
Martin Broszat	Historian	7
Andrea Bræin Hovig	Insurance Broker	0
John Hope Franklin	Historian	7
John G. Barnard	Insurance Broker	0
James B. Allen (historian)	Historian	7
Patricia Aakhus	Insurance Broker	0
Reed Waller	Dancer	7
Hashim al-Atassi	Insurance Broker	0
Jawed Wassel	Dancer	7
Patrick van den Brink	Insurance Broker	0
Iza Calzado	Dancer	7
José Sócrates	Insurance Broker	0
Nicholas Marsicano	Dancer	7
Kim Gordon	Scientist	0
Richard E. Lawyer	Lawyer	7
Jasna Samic	Scientist	0
Mason Spencer	Lawyer	7
Jaime Valdés	Scientist	0
John J. Bennett, Jr.	Lawyer	7
Dabney Cosby	Scientist	0
A. M. Sullivan (lawyer)	Lawyer	7
Alison Lohman	Scientist	0
Malik Ghulam Yasin Chhina	Lawyer	7
Chandra Shekhar Dubey	Scientist	0
Gianni Agnelli	Lawyer	7
Karla M. Gray	Scientist	0
Jonathan Falwell	Lawyer	7
John de Menteith	Scientist	0
Marshall Colt	Psychologist	7
Ikioi Shōta	Scientist	0
Michael Argyle (psychologist)	Psychologist	7
Kristy Hill	Scientist	0
Francis McNamara	Poet	7
Charles Scott Sherrington	Animator	0
Stefán Hörður Grímsson	Poet	7
Robert Kirshner	Animator	0
Mark Doty	Poet	7
Sandra Peterson (politician)	Animator	0
Bill Manhire	Poet	7
Frederick Drimmer	Animator	0
Ken Brewer	Poet	7
Diamond Dixon	Animator	0
Ahmed Shawqi	Poet	7
Red Cloud	Animator	0
Nagarjun	Poet	7
Mabel Paige	Animator	0
John Keegan Casey	Poet	7
Natasha Trethewey	Animator	0
Duo Duo	Poet	7
Oszkár Asboth	Animator	0
Yuriy Tarnawsky	Poet	7
Kaljo Põllu	Animator	0
Tom Pickard	Poet	7
Alfred Hsing	Writer	0
Sydney Lea	Poet	7
Tetsuya Chiba	Writer	0
Julie Carr	Poet	7
Rubin Goldmark	Writer	0
Fred Wah	Poet	7
Max von Forckenbeck	Writer	0
Michael S. Harper	Poet	7
Jace Hall	Writer	0
Gérard Rudolf	Poet	7
Bunny Roger	Writer	0
Amy Lowell	Poet	7
Kristin Prim	Writer	0
Abiodun Oyewole	Poet	7
George Harris (actor)	Writer	0
Kathleen Hawkins	Poet	7
Emile de Ruelle	Writer	0
Muhamad Salih Dilan	Poet	7
Lee Run Hu	Writer	0
Rovshan Javadov	Police officer	7
Mark J. Sullivan	Rodeo performer	0
Martin Cardinal	Police officer	7
Paolo Hewitt	Rodeo performer	0
Joe Jackson (police officer)	Police officer	7
Fred LaBour	Rodeo performer	0
Balbir Singh Kullar	Police officer	7
Wang Ziyun	Rodeo performer	0
Peter Clarke (police officer)	Police officer	7
Helen Clitheroe	Rodeo performer	0
James Zadroga	Police officer	7
Pachara Chirathivat	Rodeo performer	0
Salah Zulfikar	Police officer	7
Mateusz Bąk	Rodeo performer	0
Georg Cantor	Cantor	7
Shawn Christian	Rodeo performer	0
Itatí Cantoral	Cantor	7
Glen E. Conrad	Rodeo performer	0
Anacani	Cantor	7
Narayan Chandra Borkataky	Rodeo performer	0
Nancy Cantor	Cantor	7
Kirsten Gum	Pilot	0
Leslie Finer	Statesman	7
Jeff Ross	Pilot	0
Mark Helprin	Statesman	7
Stan Wentzel	Pilot	0
Siegfried Lipiner	Librarian	7
Tengiz Kitovani	Pilot	0
Robyn Butler	Librarian	7
Cathy Minehan	Pilot	0
Isaac Bickerstaffe	Librettist	7
Juan Calzadilla	Pilot	0
Yen-j	Songwriter	7
Gary Patterson	Pilot	0
Valvin Roane	Songwriter	7
Mansour bin Zayed Al Nahyan	Pilot	0
Enrico Blasi	Coach	7
Susan Kandel	Pilot	0
Reggie Minton	Coach	7
Antônio Tenório Silva	Pilot	0
Carl Rees	Coach	7
Ken Shamrock	Manager	0
Kris Kamm	Coach	7
Gloria Ladson-Billings	Manager	0
Dave Pietramala	Coach	7
Greg Piper	Manager	0
Stan Drayton	Coach	7
David Hirst (footballer)	Manager	0
Mickey Callaway	Coach	7
James Disney	Manager	0
Ken Miller (gridiron football)	Coach	7
Aleksandr Petrov (athlete)	Manager	0
Matt Rhule	Coach	7
Juan de Aguilar Villaquirán	Manager	0
Keith LeClair	Coach	7
David Kavelasvili	Manager	0
Steve Hecht	Coach	7
Oliver Winfield Killam	Manager	0
Jon Debus	Coach	7
Tetsuo Kagawa	Manager	0
Tony Rossi (baseball)	Coach	7
Adam Jamal Craig	Businessperson	0
Chuck Dickerson	Coach	7
Lucia Bosè	Businessperson	0
Grant Stoelwinder	Coach	7
Danny Moss	Businessperson	0
Greg Schiano	Coach	7
Ladislav Rybánsky	Businessperson	0
Marvin Sanders	Coach	7
Steve McLaughlin	Businessperson	0
Brad Brownell	Coach	7
Marc Prensky	Businessperson	0
Mark Quinn	Coach	7
Steve Bjorklund	Businessperson	0
Jonathan Coachman	Coach	7
Cleo Rocos	Businessperson	0
Bill Hodges	Coach	7
Todd Rutherford	Businessperson	0
Scott Bostwick	Coach	7
Michael Robinson (footballer)	Businessperson	0
Bubba Diggs	Coach	7
Ciaran Williams	Pin-up girl	0
Thomas Carter (director)	Coach	7
Amleto Palermi	Pin-up girl	0
Muffet McGraw	Coach	7
Wong Yue	Pin-up girl	0
Bobby Petrino	Coach	7
John Mullin (footballer)	Pin-up girl	0
Bill Squires	Coach	7
John Nalbone	Pin-up girl	0
Mark Dantonio	Coach	7
Patrick Connor (actor)	Pin-up girl	0
Jacob Cruz	Coach	7
Tony Phelan	Pin-up girl	0
Frederick Stoward	Botanist	7
Olof Molander	Pin-up girl	0
Holland Davis	Pastor	7
R. Rathnavelu	Pin-up girl	0
Pastor Vega	Pastor	7
Victor Aller	Pin-up girl	0
Alistair Begg	Pastor	7
Martin Rossiter	Journalist	0
István Pásztor (politician)	Pastor	7
Anouar Kali	Journalist	0
Marco Pastors	Pastor	7
Brad Keywell	Journalist	0
Orator F. Cook	Orator	7
Aristomenis Kontogouris	Journalist	0
Jerry Robinson	Cartoonist	7
Steve Holt (Canadian musician)	Journalist	0
Edwin Francis Carpenter	Carpenter	7
David Bale	Journalist	0
Karen Carpenter	Carpenter	7
Patrick Guerriero	Journalist	0
Paul Carpenter (actor)	Carpenter	7
Conya Doss	Journalist	0
Sharon Carpenter	Carpenter	7
Emma Vieceli	Journalist	0
John Carpenter	Carpenter	7
Robert Q. Lewis	Journalist	0
Grant Carpenter	Carpenter	7
Kent Hill	Consultant	0
Harry Carpenter	Carpenter	7
Joshua Sternin	Consultant	0
George F. Brock	Carpenter	7
Wilfred Harold Munro	Consultant	0
John Alden Carpenter	Carpenter	7
Joy Leftow	Consultant	0
Frank H. Maynard	Carpenter	7
Ivan Dovgodko	Consultant	0
Bobby Di Cicco	Carpenter	7
Ferdinand Sarrien	Consultant	0
Lewis C. Carpenter	Carpenter	7
Cherrelle	Consultant	0
Richard Carpenter (screenwriter)	Carpenter	7
Anton de Haen	Consultant	0
Russell Carpenter	Carpenter	7
Martin Kornmesser	Consultant	0
James Carpenter (astronomer)	Carpenter	7
Augusto de Lima	Consultant	0
Crystal Chappell	Carpenter	7
Harold Cohen (politician)	Electronic musician	0
Jennifer Carpenter	Carpenter	7
Michael Lark	Electronic musician	0
Ron Tutt	Carpenter	7
Leo Roy	Electronic musician	0
Holly Carpenter	Carpenter	7
Susan Estelle Jansen	Electronic musician	0
Ray Nelson	Carpenter	7
Sir William Congreve, 2nd Baronet	Electronic musician	0
Lemuel Carpenter	Carpenter	7
Billy Gardner, Jr.	Electronic musician	0
Frank Soltis	Scientist	7
Tony Caunter	Electronic musician	0
Pavlo Hai-Nyzhnyk	Scientist	7
Joshua Donen	Electronic musician	0
Ben Goertzel	Scientist	7
Russell Brown (New Zealand)	Electronic musician	0
Garth Gibson	Scientist	7
Axel Bakunts	Electronic musician	0
Edith Widder	Scientist	7
Sergei P. Kurdyumov	Broadcaster	0
Brian Yuzna	Animator	7
Warren Cummings	Broadcaster	0
Jeffrey Combs	Animator	7
Dorothy Wilson (actress)	Broadcaster	0
Nigar Rafibeyli	Writer	7
Norval Morrisseau	Broadcaster	0
Guillermo Marín Ruiz	Writer	7
Deirdre Bair	Broadcaster	0
Joan Thomas	Writer	7
Shai Abuhatsira	Broadcaster	0
Anila Baig	Writer	7
Olive Blakeney	Broadcaster	0
Kim Krizan	Writer	7
Bryan Lourd	Broadcaster	0
Judith Levine	Writer	7
Reg Sinclair	Broadcaster	0
Jim Souhan	Writer	7
David Sabiston	Broadcaster	0
Tim Kirkman	Writer	7
C. Jérôme	Public speaker	0
Daniel Alarcón	Writer	7
Jake Hewitt	Public speaker	0
Asitha Ameresekere	Writer	7
Leslie Stephen-Smith	Public speaker	0
Joan Smith	Writer	7
Francine Tacker	Public speaker	0
Veronika Tushnova	Writer	7
Kaka Hathrasi	Public speaker	0
Pierre Pilote	Pilot	7
Steve Davis	Public speaker	0
August Euler	Pilot	7
Kate Shelley	Public speaker	0
Kiki Lesendrić	Pilot	7
Mike Goldman	Public speaker	0
Joseph Kittinger	Pilot	7
George H. Bryan	Public speaker	0
Dean DeLeo	Pilot	7
Dallas Williams	Public speaker	0
Michael A. Baker	Manager	7
Joseph A. McDonald	Football player	0
Red Kellett	Manager	7
Jesús Alique	Football player	0
Eric Ortner	Manager	7
Eleanor King	Football player	0
Ben Graham (football player)	Manager	7
Autolycus of Pitane	Football player	0
Temel Kotil	Manager	7
Elsie Janis	Football player	0
Vinny Cerrato	Manager	7
Ali Al-Sebaa	Football player	0
Paige Kelton	Manager	7
Simon Stephens	Football player	0
Rassie Erasmus	Manager	7
John Calvin Jureit	Football player	0
Edward Clouston	Manager	7
Hiroshi Ogawa (animator)	Football player	0
Barry Mower	Businessperson	7
Maurice Bedel	Football player	0
Jane King (journalist)	Journalist	7
Erik Wroldsen	Radio personality	0
Subramaniam Ramachandran	Journalist	7
Roland Grossenbacher	Radio personality	0
Doug Krikorian	Journalist	7
Becky Smith	Radio personality	0
Daniel Rosenberg	Journalist	7
Phil Russell (ice hockey)	Radio personality	0
Christina Brown	Journalist	7
Lori Nelson	Radio personality	0
Alice Klein	Journalist	7
Riemke Ensing	Radio personality	0
Ken Sunshine	Consultant	7
Michael Bidwill	Radio personality	0
Ralph Townsend (headmaster)	Consultant	7
Amarkhuu Borkhuu	Radio personality	0
Brian Reffin Smith	Electronic musician	7
Jenő Hamburger	Radio personality	0
Bernd Friedmann	Electronic musician	7
Igor Ledogorov	Radio personality	0
Jeff Robinson (American football)	Football player	7
Leroy Sibbles	Commentator	0
Kyle Martin (footballer)	Football player	7
James Kugel	Commentator	0
Josh Bourke	Football player	7
John Waite (broadcaster)	Commentator	0
Ken Keuper	Football player	7
John Weathers	Commentator	0
Joe Kozlowsky	Football player	7
Jeffrey D. Sadow	Commentator	0
Stuart Dew	Football player	7
Jack Stehlin	Commentator	0
Shadrick McAfee	Football player	7
Alec Seward	Commentator	0
Nick Dal Santo	Football player	7
Pamela Hansford Johnson	Commentator	0
Brodie Grundy	Football player	7
Isabelle LaMal	Commentator	0
Dan Conners	Football player	7
King Parsons	Commentator	0
James Hird	Football player	7
Mindy McCready	Revolutionary	0
Rory Laird	Football player	7
Dési Bouterse	Revolutionary	0
Walt Garrison	Football player	7
Paul Scofield	Revolutionary	0
Max Oppy	Football player	7
Daven "Prestige" Vanderpool	Revolutionary	0
Jack Anthony (footballer)	Football player	7
Brett McLeod	Revolutionary	0
Warren Wells	Football player	7
Arnold Gamson	Revolutionary	0
Cale Morton	Football player	7
Lauren Hewett	Revolutionary	0
Neil Lumsden	Football player	7
Robert Stewart, Viscount Castlereagh	Revolutionary	0
Hugh Devore	Football player	7
Nigel Smith (footballer, born 1958)	Revolutionary	0
Lincoln McCarthy	Football player	7
Richard Louv	Revolutionary	0
James Podsiadly	Football player	7
Frits Meuring	Music Producer	0
Booker Edgerson	Football player	7
David Brancaccio	Music Producer	0
Khari Jones	Football player	7
Husayn Rosowsky	Music Producer	0
Sam Dunell	Football player	7
Roxanne Beckford	Music Producer	0
Tom Jonas	Football player	7
Natalie Nicholson	Music Producer	0
Mark Rypien	Football player	7
Daphney Hlomuka	Music Producer	0
Todd Banfield	Football player	7
João Amazonas	Music Producer	0
Guy McKenna	Football player	7
Darren Turcotte	Music Producer	0
Alan Toovey	Football player	7
Stella Maeve	Music Producer	0
Rebecca Judd	Football player	7
Mustafa Altıoklar	Music Producer	0
Darren Crocker	Football player	7
John Tengo Jabavu	Military aviator	0
Tom Rathman	Football player	7
François-Joseph Talma	Military aviator	0
Nathan van Berlo	Football player	7
John Herbert Quick	Military aviator	0
Elbie Schultz	Football player	7
Henrietta Vinton Davis	Military aviator	0
Dieter Brock	Football player	7
Niko (musician)	Military aviator	0
Willie Buchanon	Football player	7
Paul Baltes	Military aviator	0
Eddie Betts	Football player	7
Andrew Butler	Military aviator	0
Jamie Henderson	Football player	7
Derya Alabora	Military aviator	0
Jordan Murdoch	Football player	7
Fineasi Palei	Military aviator	0
Cedric Minter	Football player	7
José Serra	Military aviator	0
Stephen Wrigley	Football player	7
David Croll	Speechwriter	0
Neil Balme	Football player	7
Amanda Hale	Speechwriter	0
Nathan Blee	Football player	7
Frederick Homes Dudden	Speechwriter	0
Anthony Long	Football player	7
Leif Grøner	Speechwriter	0
Mark Harvey	Football player	7
Barbara Brooks Wallace	Speechwriter	0
Harry Jacunski	Football player	7
Faye Adams	Speechwriter	0
John Perko	Football player	7
Alain Decaux	Speechwriter	0
Mark Blicavs	Football player	7
Joseph Nunoo-Mensah	Speechwriter	0
Jim Marsalis	Football player	7
Manuel Osborne-Paradis	Speechwriter	0
Sam Lonergan	Football player	7
Laura Karpman	Speechwriter	0
Noah Jackson	Football player	7
Bob Zick	Actor	0
Sam Jacobs (Australian footballer)	Football player	7
Max Colpet	Actor	0
Dick Jauron	Football player	7
Russ George	Actor	0
Steele Sidebottom	Football player	7
Aleksandr Khvan	Actor	0
Amobi Okoye	Football player	7
José Antonio Viera-Gallo	Actor	0
John Matsko	Football player	7
Sidney Michaels	Actor	0
Jarryd Hayne	Football player	7
Valerio Di Cesare	Actor	0
Bernard St-Laurent (broadcaster)	Radio personality	7
Joseph Forte	Actor	0
Jim Brown (radio host)	Radio personality	7
Anthony Holles (actor)	Actor	0
Brian Carthy	Commentator	7
Mary James (educator)	Actor	0
Armand Louis de Gontaut	Revolutionary	7
Martin Ferris	Fashion Designer	0
Tomás Ruiz González	Revolutionary	7
Steve Sciullo	Fashion Designer	0
Patricio Martínez García	Revolutionary	7
Ildikó Bánsági	Fashion Designer	0
Hermann Rauschning	Revolutionary	7
Peter Berngardovich Struve	Fashion Designer	0
Jean-Anne Christy de la Pallière	Revolutionary	7
Stefano Eranio	Fashion Designer	0
Nicholas Fish	Revolutionary	7
Marco Sau	Fashion Designer	0
Manuel Cavazos Lerma	Revolutionary	7
Satoshi Kon	Fashion Designer	0
Ma Buluan	Revolutionary	7
Simon Stevin	Fashion Designer	0
Andrew Adams (congressman)	Revolutionary	7
Cyrus H. Gordon	Fashion Designer	0
James Irvine (Pennsylvania)	Revolutionary	7
Gbenga Daniel	Fashion Designer	0
Jacques Nicolas Billaud-Varenne	Revolutionary	7
René Moore	Psychoanalyst	0
Uchechi Kalu	Revolutionary	7
Ján Vilček	Psychoanalyst	0
William Eustis	Revolutionary	7
George Gerken	Psychoanalyst	0
Artemas Ward	Revolutionary	7
Khalid bin Ahmed Al Khalifa	Psychoanalyst	0
Stevens Thomson Mason (Virginia)	Revolutionary	7
Mei Qing	Psychoanalyst	0
Arthur Moeller van den Bruck	Revolutionary	7
Paul Jaeg	Psychoanalyst	0
David Bushnell	Revolutionary	7
Keith Rothfus	Psychoanalyst	0
Francisco Guterres	Revolutionary	7
Steve Zahn	Psychoanalyst	0
Johannes de Graaff	Revolutionary	7
André Fomitschow	Psychoanalyst	0
Theo Heemskerk	Revolutionary	7
Elsdon Storey	Psychoanalyst	0
Mohammad Rouyanian	Revolutionary	7
Stacy-Deanne	Priest	0
John Crittenden, Sr.	Revolutionary	7
Leo P. Carlin	Priest	0
James Duane	Revolutionary	7
Hari Kostov	Priest	0
Charles McKnight	Revolutionary	7
Joe Koshansky	Priest	0
Bernard Coard	Revolutionary	7
Jackie Edwards (musician)	Priest	0
Pauline Maier	Revolutionary	7
Arturo Freeman	Priest	0
Miguel Alonso Reyes	Revolutionary	7
Vincent Bueno	Priest	0
James Ewing (Pennsylvania)	Revolutionary	7
Nabil Ayouch	Priest	0
Jean-Baptiste Robert Lindet	Revolutionary	7
Tony MacFarland	Priest	0
James Potter	Revolutionary	7
Norman Rodway	Priest	0
Ma Ju-lung	Revolutionary	7
Gregory Henriquez	Photographer	0
Barend Biesheuvel	Revolutionary	7
Nanette Newman	Photographer	0
Thomas Blount (statesman)	Revolutionary	7
James Gardiner (Scottish politician)	Photographer	0
Chen Cheng	Revolutionary	7
Shiulie Ghosh	Photographer	0
Miguel Borge Martín	Revolutionary	7
Ethan Phillips	Photographer	0
Claude Victor-Perrin, Duc de Belluno	Revolutionary	7
Amado Yuzon	Photographer	0
Pieter Sjoerds Gerbrandy	Revolutionary	7
José Antonio Errázuriz	Photographer	0
William Alexander, Lord Stirling	Revolutionary	7
Greg Fox (cartoonist)	Photographer	0
Pierce Butler	Revolutionary	7
Marilyn McCoo	Photographer	0
Peter Muhlenberg	Revolutionary	7
Eladio Romero Santos	Photographer	0
Jacob Adriaan de Wilde	Revolutionary	7
Joe Hatten	Evangelist	0
Nicholas Fish II	Revolutionary	7
Ernest Bong	Evangelist	0
Ma Dunjing (1906–1972)	Revolutionary	7
Walter J. Turner	Evangelist	0
Fred Zinn	Military aviator	7
Marcus Canty	Evangelist	0
Clifton Powell	Actor	7
David J. Hudson	Evangelist	0
Jay Tavare	Actor	7
Danny Pate	Evangelist	0
Anne Ramsay	Actor	7
Tracy Beckman	Evangelist	0
Milton Katselas	Actor	7
Natalie Dormer	Evangelist	0
Kıvanç Tatlıtuğ	Actor	7
John Hendy (barrister)	Evangelist	0
Ryūzaburō Ōtomo	Actor	7
James Jamieson (doctor)	Evangelist	0
Nic Romm	Actor	7
Hemanth Menon	Judge	0
Ayush Mahesh Khedekar	Actor	7
Kevin De Cock	Judge	0
Kevin Interdonato	Actor	7
Morgan Robertson	Judge	0
Patrick Quinn	Actor	7
Mike Polk	Judge	0
Francisco Melo	Actor	7
Peter Holmes à Court	Judge	0
Paul Popplewell	Actor	7
Dwayne Harris	Judge	0
Motilal (actor)	Actor	7
Karl Alfred von Zittel	Judge	0
Roger Bart	Actor	7
Nawazuddin Siddiqui	Judge	0
Gara Takashima	Actor	7
Masato Akamatsu	Judge	0
Jai Koutrae	Actor	7
Stew Thornley	Judge	0
Kunal Kumar	Actor	7
Cub Stricker	Choreography	0
Fyvush Finkel	Actor	7
Moby	Choreography	0
Mark Wakeling	Actor	7
Celso Lafer	Choreography	0
Susan Batson	Actor	7
Andre Dubus	Choreography	0
P. J. Antony	Actor	7
Jerome Zerbe	Choreography	0
Scott Travis	Priest	7
Fatty Briody	Choreography	0
Lady Rhea	Priest	7
Roger Reinert	Choreography	0
Ron O'Neal	Priest	7
Marlon Roudette	Choreography	0
Manasseh (High Priest)	Priest	7
Rod Williams (Canadian football)	Choreography	0
Lee Priest	Priest	7
Lesego Rampolokeng	Choreography	0
George F. Regas	Priest	7
Gary Agnew	Musician	0
Annas	Priest	7
Nasrollah Jahangard	Musician	0
Les Binks	Priest	7
Ilya Ilyin	Musician	0
Jason Priestley	Priest	7
Stipe Perica	Musician	0
Cherie Priest	Priest	7
Vern Oech	Musician	0
Heron Carvic	Priest	7
Jethro Franklin	Musician	0
Maurice Priestley	Priest	7
Joe Thornton	Musician	0
Mathew Priest	Priest	7
Jonah Bayliss	Musician	0
Al Atkins	Priest	7
Harley M. Kilgore	Musician	0
Dave Holland (drummer)	Priest	7
Herbert Brenon	Musician	0
Eli (biblical figure)	Priest	7
Yoo Chae-yeong	Television presenter	0
Vivianne Crowley	Priest	7
Hildegard Westerkamp	Television presenter	0
Noah Wunsch	Photographer	7
Augustin Saint-Hilaire	Television presenter	0
Raymond Meier (photographer)	Photographer	7
Dewi Persik	Television presenter	0
Alexander Duncan McRae	Photographer	7
Konoe Atsumaro	Television presenter	0
Karimeh Abbud	Photographer	7
Jessica Parker Kennedy	Television presenter	0
Ben Katchor	Photographer	7
Raden Patah	Television presenter	0
David Mecey	Photographer	7
Rafael Vaz	Television presenter	0
Crisanto Evangelista	Evangelist	7
Beau Maister	Television presenter	0
Johann Evangelist Haydn	Evangelist	7
Cullen Harper	Television presenter	0
Jeyow Evangelista	Evangelist	7
Oscar Ruffini	Cinematographer	0
Philip the Evangelist	Evangelist	7
E. Elias Merhige	Cinematographer	0
Mark the Evangelist	Evangelist	7
Arnold Östman	Cinematographer	0
Linda Evangelista	Evangelist	7
Moira Kirland	Cinematographer	0
Paulo Afonso Evangelista Vieira	Evangelist	7
Garry Stewart	Cinematographer	0
Hall Hammond	Judge	7
Claire Dautherives	Cinematographer	0
Laurie Smith Camp	Judge	7
Valerie Carter	Cinematographer	0
K. S. Hegde	Judge	7
Chano Domínguez	Cinematographer	0
Louise W. Flanagan	Judge	7
David W. Turner	Cinematographer	0
Sam E. Haddon	Judge	7
John Robic	Cinematographer	0
Renato Beghe	Judge	7
Phillip Y. Kim	Audio Engineer	0
Kathleen Kerrigan	Judge	7
Michael Klukowski	Audio Engineer	0
Otis D. Wright II	Judge	7
Elena Kuschnerova	Audio Engineer	0
Cecil Clothier	Judge	7
Jim Denney (ski jumper born 1983)	Audio Engineer	0
Richard T. Haik	Judge	7
Antonio López de Santa Anna	Audio Engineer	0
Meryl Sexton	Judge	7
Bhaurao Dagadurao Deshmukh	Audio Engineer	0
Judith Sheindlin	Judge	7
B. Lenin	Audio Engineer	0
Antonio Mario La Pergola	Judge	7
Harry Worth	Audio Engineer	0
Edward Leavy	Judge	7
Deb Obarski	Audio Engineer	0
Kenneth Ryskamp	Judge	7
Simon Coates (actor)	Audio Engineer	0
Marcia S. Krieger	Judge	7
Vijay C. Kumar	Electrical engineer	0
Lucy H. Koh	Judge	7
Alex Fletcher (actress)	Electrical engineer	0
Jenny Blokland	Judge	7
Neriman Özsoy	Electrical engineer	0
John D. Bates	Judge	7
Lionel Ferbos	Electrical engineer	0
Peter Mahon (judge)	Judge	7
José Ortíz de la Renta	Electrical engineer	0
Robert Katzmann	Judge	7
Aníbal González Irizarry	Electrical engineer	0
Henry Gibson	Judge	7
Jayson Blair	Electrical engineer	0
Hugh Wyndham	Judge	7
Oscar W. Gillespie	Electrical engineer	0
Robert van Gulik	Judge	7
Chynna Phillips	Electrical engineer	0
Timothy Mark Burgess	Judge	7
Rúni Brattaberg	Electrical engineer	0
Alexander Akerman	Judge	7
Tomaž Pisanski	Educator	0
Graham Panckhurst	Judge	7
Joe Fafard	Educator	0
Michael J. Davis	Judge	7
Rick Tramonto	Educator	0
Anthony Palmer (judge)	Judge	7
Kevin Jarvis	Educator	0
Michael Boudin	Judge	7
Richard Tee	Educator	0
Rod Houison	Judge	7
Giulio Tremonti	Educator	0
Peter Quilliam	Judge	7
Rinaldo dall'Arpa	Educator	0
William Burnham Woods	Judge	7
Will Schofield	Educator	0
Alexis Smirnoff	Judge	7
Ishirō Honda	Educator	0
Felix Cassel	Judge	7
Élie Doté	Educator	0
Rebecca Jackson	Judge	7
Jimmy Osmond	Soccer Player	0
Madelyn Vega	Judge	7
Omer Nishani	Soccer Player	0
James E. Shadid	Judge	7
Alex Germains	Soccer Player	0
Kimberly Prost	Judge	7
Jucilei	Soccer Player	0
Mark Lund	Judge	7
Sofoklis Venizelos	Soccer Player	0
Elizabeth A. Kovachevich	Judge	7
Buddug Verona James	Soccer Player	0
Frank Judge	Judge	7
Asa Mahan	Soccer Player	0
Robert R. Beezer	Judge	7
Harry Carpenter	Soccer Player	0
Ricardo S. Martinez	Judge	7
George Devol	Soccer Player	0
Howard Craghead	Judge	7
James Young (Scottish chemist)	Soccer Player	0
Julie E. Carnes	Judge	7
Marius Michel Pasha	Music artist	0
Elizabeth Evatt	Judge	7
Robert Bryant (mathematician)	Music artist	0
Peter Heerey	Judge	7
Lachie Whitfield	Music artist	0
Henry Hodge	Judge	7
Josh Gifford	Music artist	0
Ruben Castillo (judge)	Judge	7
Oscar M. Ruebhausen	Music artist	0
Patricia A. Seitz	Judge	7
G. H. B. Ward	Music artist	0
Charles Markell	Judge	7
Edward Abbott (jurist)	Music artist	0
Bernard Newman (judge)	Judge	7
Guillaume Schiffman	Music artist	0
Sandra Lynch	Judge	7
Ann Fienup-Riordan	Music artist	0
Stedman Prescott	Judge	7
Robert Atzorn	Music artist	0
William St Julien Arabin	Judge	7
Kikuchi Shingaku	Art critic	0
Mills Lane	Judge	7
Christopher Bertolini	Art critic	0
Rya W. Zobel	Judge	7
Heber Doust Curtis	Art critic	0
Ann Pfau	Judge	7
Jim Braude	Art critic	0
Gregory W. Carman	Judge	7
Hans J. Müller-Eberhard	Art critic	0
Thomas A. Varlan	Judge	7
Adil Murad	Art critic	0
Robert Pirosh	Judge	7
Steve Naughton	Art critic	0
James K. Bredar	Judge	7
Katie Fforde	Art critic	0
Barry Sheen	Judge	7
Trajan	Art critic	0
George H. King	Judge	7
Alvin Gittens	Art critic	0
Edward Cashman	Judge	7
Akiko Kamei	Film Editor	0
Donald E. Belfi	Judge	7
Waldemar Matuška	Film Editor	0
Alan Kay (judge)	Judge	7
Zdeněk Šafář	Film Editor	0
Leo Cussen	Judge	7
Ulrik Schmidt	Film Editor	0
Theodor Meron	Judge	7
Sufyan al-Thawri	Film Editor	0
Peter Kerr (water polo)	Judge	7
Bella Guerin	Film Editor	0
Christopher Greenwood	Judge	7
Alvin Lie	Film Editor	0
Philip Brodie, Lord Brodie	Judge	7
Daniel Mudd	Film Editor	0
J. Leroy Adair	Judge	7
Oscar Jones	Film Editor	0
Stephanie Kulp Seymour	Judge	7
Pedro de la Rosa	Film Editor	0
Robert Warren (Irish politician)	Judge	7
George Bigelow Rogers	Playwright	0
John Carrafa	Choreography	7
Abed Bwanika	Playwright	0
Longinus Fernandes	Choreography	7
Albert Millaire	Playwright	0
Dave Scott (choreographer)	Choreography	7
Sarah Smith (news reporter)	Playwright	0
Charly García	Musician	7
María Antonieta Pons	Playwright	0
Mansour Zalzal	Musician	7
Saverio Muratori	Playwright	0
Stephen Dixon (newsreader)	Television presenter	7
Anthony Hamilton-Smith, 3rd Baron Colwyn	Playwright	0
Deirdre Cartwright	Television presenter	7
Pete Henning	Playwright	0
Kay Gregory	Television presenter	7
Bojan Westin	Playwright	0
Angela Finger-Erben	Television presenter	7
Mariette Rix	Playwright	0
Maasa Takahashi	Television presenter	7
Brian Cass	Screenwriter	0
Leonard Miron	Television presenter	7
Adrian Klemm	Screenwriter	0
Bob Preedy	Television presenter	7
Murray Chotiner	Screenwriter	0
Tamara Benitez	Cinematographer	7
Elizabeth Chase Allen	Screenwriter	0
L.D. Clawson	Cinematographer	7
Andrew Goffman	Screenwriter	0
Ravi Varman	Cinematographer	7
Anne Ramsay	Screenwriter	0
Kovelamudi Surya Prakash Rao	Cinematographer	7
Ruth Lee	Screenwriter	0
Valeriu Jereghi	Cinematographer	7
Orlando Woolridge	Screenwriter	0
Sophie Delila	Music artist	7
Bill Longmuir	Screenwriter	0
Terry McBride (CEO)	Music artist	7
Peter Berg	Screenwriter	0
Che'Nelle	Music artist	7
Bill Frist	Rapper	0
Kathryn Williams	Music artist	7
William H. Pryor, Jr.	Rapper	0
Flame (rapper)	Music artist	7
Mary Maude	Rapper	0
David Ahern	Music artist	7
Colin Eggleston	Rapper	0
Nancy Ajram	Music artist	7
Chick Hearn	Rapper	0
Yvor Winters	Art critic	7
Jim Barbieri	Rapper	0
Achille Bonito Oliva	Art critic	7
Stephen Longstreet	Rapper	0
Artemy Troitsky	Art critic	7
Sergey Nikolsky	Rapper	0
Arthur Danto	Art critic	7
Edward A. Biery	Rapper	0
Michael Francis Gibson	Art critic	7
Yu Tokui	Rapper	0
Arthur Waugh	Art critic	7
Phyllis Newman	Choreographer	0
Frank Arthur Swinnerton	Art critic	7
Tom Sims	Choreographer	0
Louisa Buck	Art critic	7
Alan Isler	Choreographer	0
Enrique Laguerre	Art critic	7
Suanne Braun	Choreographer	0
Alec Waugh	Art critic	7
Pavlo Stepanets	Choreographer	0
Arthur Henry Mann (journalist)	Art critic	7
Nixey Callahan	Choreographer	0
Richard Vetere	Playwright	7
Rogvold Sukhoverko	Choreographer	0
Han Ong	Playwright	7
Sammy Cahn	Choreographer	0
Cristóbal Krusen	Screenwriter	7
Geoffrey Thorne	Choreographer	0
Francis Magalona	Rapper	7
Ibrahim El Batout	Choreographer	0
Klashnekoff	Rapper	7
Sergey Nikitin (musician)	Accountant	0
Y. H. Malegam	Accountant	7
Manuel Cajuda	Accountant	0
David J. Porter	Accountant	7
Massimo Pirri	Accountant	0
Karl Rathgen	Economist	7
Howie Rose	Accountant	0
Martin Agbaso	Economist	7
Eric Denis	Accountant	0
Lars Lefgren	Economist	7
Speckled Red	Accountant	0
John Teerlinck	American football player	7
Israel Segal	Accountant	0
Whitney Lewis	American football player	7
Arnold Resnicoff	Accountant	0
Jason Witczak	American football player	7
Kolleen Park	Accountant	0
Paul Hofer	American football player	7
Marion Nestle	Accountant	0
Larry Stallings	American football player	7
Herman Verlinde	Scenic Designer	0
Hart Lee Dykes	American football player	7
Mohsin Hamid	Scenic Designer	0
Steve Kragthorpe	American football player	7
Marquis Childs	Scenic Designer	0
Ray Ramsey	American football player	7
Juno Mak	Scenic Designer	0
Don Brown (American football coach)	American football player	7
Dave Carter (actor)	Scenic Designer	0
Charlie Sadler	American football player	7
Nedeljko Bajić Baja	Scenic Designer	0
Jim Donnan	American football player	7
Peter Lhotka	Scenic Designer	0
Marc Boerigter	American football player	7
Petr Shelokhonov	Scenic Designer	0
Bill Snyder	American football player	7
Robbie Fowler	Scenic Designer	0
Sam McCullum	American football player	7
Ian Payne (sports broadcaster)	Scenic Designer	0
Jim Hofher	American football player	7
Pavel Sukhoi	Economist	0
Del Rodgers	American football player	7
Jennifer Rexford	Economist	0
Brent McClanahan	American football player	7
Ian Gordon Lindsay	Economist	0
Century Milstead	American football player	7
Choudhry Rahmat Ali	Economist	0
Lou Tepper	American football player	7
Marcy Harriell	Economist	0
Milt Gantenbein	American football player	7
Don Marshall (actor)	Economist	0
Greg Mattison	American football player	7
Bor S. Luh	Economist	0
Steve Spurrier	American football player	7
Juma'at Jantan	Economist	0
John H. Outland	American football player	7
Anneli Heed	Economist	0
Mike Sheppard	American football player	7
Roberto Faenza	Economist	0
Dennis Raetz	American football player	7
Max Muspratt	TV Personality	0
Gabby Price	American football player	7
William Wirt Vaughan	TV Personality	0
Jamie Cruce	American football player	7
Colin Ronan	TV Personality	0
Larry Blakeney	American football player	7
Kadeem Hardison	TV Personality	0
Bobby Lamb (American football)	American football player	7
James Dwight Dana	TV Personality	0
Bruce Taylor (American football)	American football player	7
Anderson Mazoka	TV Personality	0
Lane Kiffin	American football player	7
Herana-Daze Jones	TV Personality	0
Chuck Reedy	American football player	7
Bill Gaither (blues musician)	TV Personality	0
Gary Darnell	American football player	7
Kenny King (wrestler)	TV Personality	0
Troy Calhoun	American football player	7
Frederick S. Armitage	TV Personality	0
Willie Drewrey	American football player	7
Giovanna Palermi	Anthropologist	0
Greg McMurtry	American football player	7
Koby Arthur	Anthropologist	0
Jon Giesler	American football player	7
Richard L. Van Enger	Anthropologist	0
Jack Mitchell (American football)	American football player	7
Ted Cassidy	Anthropologist	0
Howard Hobson	American football player	7
Suzanne Crough	Anthropologist	0
Derrick Cullors	American football player	7
Yeo Yann Yann	Anthropologist	0
Paul Rhoads	American football player	7
Satinath Sarangi	Anthropologist	0
Jack Sisco	American football player	7
Jacobus de Voragine	Anthropologist	0
Bernie Casey	American football player	7
Arius Didymus	Anthropologist	0
Ian Gold	American football player	7
Jennifer Campbell	Anthropologist	0
Earl Girard	American football player	7
Lou Thesz	Theoretical Physicist	0
Jim Herrmann	American football player	7
Henry Pettitt	Theoretical Physicist	0
Robert Hoernschemeyer	American football player	7
Rob Collins (musician)	Theoretical Physicist	0
Dwayne Woodruff	American football player	7
Jean Charles Snoy et d'Oppuers	Theoretical Physicist	0
Tamarick Vanover	American football player	7
Bernard Arcand	Theoretical Physicist	0
Walt Corey	American football player	7
Nilakantha Somayaji	Theoretical Physicist	0
Ray Buchanan	American football player	7
Jason Wade	Theoretical Physicist	0
Walt Schlinkman	American football player	7
Allan Eshuijs	Theoretical Physicist	0
Brad Benson	American football player	7
Theresa Schwegel	Theoretical Physicist	0
Haywood Jeffires	American football player	7
Placide Poulin	Theoretical Physicist	0
Rocky Bleier	American football player	7
John McCullough (basketball)	Neurologist	0
Charlie Caldwell	American football player	7
Émile-Justin Menier	Neurologist	0
Mick Dennehy	American football player	7
Fernanda Paes Leme	Neurologist	0
Jeff Jagodzinski	American football player	7
Rolf Hellem	Neurologist	0
Gary Dunn	American football player	7
Mor Karbasi	Neurologist	0
Jeff Genyk	American football player	7
Anatoly Sheludyakov	Neurologist	0
Steve Pisarkiewicz	American football player	7
Alfred Fowler	Neurologist	0
Chuck Heater	American football player	7
Wilfred Lau	Neurologist	0
Joe Maniaci	American football player	7
Gary Deegan	Neurologist	0
Raghib Ismail	American football player	7
Bill Brochtrup	Neurologist	0
Lonnie Warwick	American football player	7
Jackie Paterson	American football player	0
Mark Kelso	American football player	7
Gösta Krantz	American football player	0
Merv Pregulman	American football player	7
Wade Rowland	American football player	0
Chet A. Wynne	American football player	7
Héctor Ramírez (baseball)	American football player	0
Paul Wiggin	American football player	7
Eivind Brydøy	American football player	0
Pierce Holt	American football player	7
Vilho Väisälä	American football player	0
Steve Worster	American football player	7
Shimaki Kensaku	American football player	0
Craig Stump	American football player	7
Paul Gage	American football player	0
Louis Green	American football player	7
Anthony Scotto	American football player	0
Mike Reinfeldt	American football player	7
Frank Popper	American football player	0
George Ragsdale	American football player	7
Juan Manuel Benítez	Presenter	0
Mike Gottfried	American football player	7
Neil H. McElroy	Presenter	0
Brian VanGorder	American football player	7
Jacob Mulenga	Presenter	0
Ivory Sully	American football player	7
Anja Coleby	Presenter	0
Russell Erxleben	American football player	7
Cristian Darío Álvarez	Presenter	0
Maurice Bennett Flynn	American football player	7
Barnaby Conrad III	Presenter	0
George Small (American football)	American football player	7
Shamim Karhani	Presenter	0
Gary Patterson	American football player	7
Kevin McCabe (economist)	Presenter	0
Kynan Forney	American football player	7
Jimmy Murphy (footballer)	Presenter	0
Justin Skaggs	American football player	7
Elena Skochilo	Presenter	0
Mike Hammerstein	American football player	7
Peter Kennedy (priest)	Philanthropist	0
Harry Arista Mackey	American football player	7
Annie Adams Fields	Philanthropist	0
Freddie Joe Nunn	American football player	7
Elton Dean	Philanthropist	0
Frank McRae	American football player	7
Montrose Hagins	Philanthropist	0
Eddie Cameron	American football player	7
Bernardo Corradi	Philanthropist	0
Mike Saxon	American football player	7
Joanna Jabłczyńska	Philanthropist	0
Jim Mandich	American football player	7
Abhishiktananda	Philanthropist	0
Ed Goddard	American football player	7
G. E. Stinson	Philanthropist	0
Ron W. Miller	American football player	7
Shipra Khanna	Philanthropist	0
Jack Kemp	American football player	7
Adolf Bastian	Philanthropist	0
Ron Widby	American football player	7
Struan Sutherland	Keyboard player	0
Dinny McNamara	American football player	7
Margarita Ostolaza	Keyboard player	0
Jim Tressel	American football player	7
Guillermo Calvo	Keyboard player	0
Dabo Swinney	American football player	7
Balram Chainrai	Keyboard player	0
Ken Burrough	American football player	7
Alfred Horn	Keyboard player	0
Marcus Vick	American football player	7
Nevin Yanıt	Keyboard player	0
Dick Stanfel	American football player	7
Jason Smilovic	Keyboard player	0
Pat Narduzzi	American football player	7
Kojo Botsio	Keyboard player	0
George Seifert	American football player	7
Christopher Odhiambo Okinda	Keyboard player	0
Carl Franks	American football player	7
Neil Patrick Harris	Keyboard player	0
Kalani Sitake	American football player	7
Edwin Arlington Robinson	Bureaucrat	0
Chris Mussman	American football player	7
Jun Kondo	Bureaucrat	0
Andre Reed	American football player	7
Juan d'Arienzo	Bureaucrat	0
Chike Okeafor	American football player	7
Aravinda de Silva	Bureaucrat	0
Larry Smith (American football coach)	American football player	7
S. V. Krishna Reddy	Bureaucrat	0
Steve Atwater	American football player	7
Billy Beck	Bureaucrat	0
Jim Lind (American football)	American football player	7
Nils Aall Barricelli	Bureaucrat	0
Weegie Thompson	American football player	7
Abdoulaye Sékou Sow	Bureaucrat	0
Hal Mumme	American football player	7
Tommy Corcoran (baseball)	Bureaucrat	0
Jody Sears	American football player	7
Rodolfo Dantas Bispo	Bureaucrat	0
Antwoine Womack	American football player	7
Vaniity	Meteorologist	0
Woody Wagenhorst	American football player	7
Moses ben Jacob Cordovero	Meteorologist	0
Willard Scissum	American football player	7
Chris Beard (basketball)	Meteorologist	0
Chris Meidt	American football player	7
David Drew Zingg	Meteorologist	0
Mike Zordich	American football player	7
David Borrow	Meteorologist	0
Jarrett Irons	American football player	7
Allen Stack	Meteorologist	0
Ben McGee	American football player	7
Denise Dillon	Meteorologist	0
Leon Manley	American football player	7
Clóvis Beviláqua	Meteorologist	0
George Sauer	American football player	7
Luke Snellin	Meteorologist	0
Jack Myers (American football)	American football player	7
Benny Yau	Meteorologist	0
Mike Canales	American football player	7
Fred Underwood	Pornographic actor	0
Lee McClung	American football player	7
Christian Señeres	Pornographic actor	0
Dante Booker	American football player	7
Linda Estrella	Pornographic actor	0
Norries Wilson	American football player	7
Alice Neel	Pornographic actor	0
Eric Hipple	American football player	7
Philip Haythornthwaite	Pornographic actor	0
Pat Dye	American football player	7
Henry Roman Nose	Pornographic actor	0
Jumbo Elliott (American football)	American football player	7
Mar'i Pasha al-Mallah	Pornographic actor	0
Lou Abbruzzi	American football player	7
Albert Aftalion	Pornographic actor	0
Tyrone Willingham	American football player	7
Natalie Venetia Belcon	Pornographic actor	0
Albert Baisy	American football player	7
Albert Armitage	Pornographic actor	0
Bo Molenda	American football player	7
Robert Connelly	Talk show host	0
Joe Cocozzo	American football player	7
Steven G. Kellman	Talk show host	0
Roderick Cox	American football player	7
Jayne Eastwood	Talk show host	0
Irv Smith	American football player	7
Mary Murphy (politician)	Talk show host	0
John Petitbon	American football player	7
Roger Bruns	Talk show host	0
Pat Hill	American football player	7
Yara Amaral	Talk show host	0
John Luckhardt	American football player	7
Muhammad Aslam Khan Khattak	Talk show host	0
Sam Wyche	American football player	7
John F. O. Bilson	Talk show host	0
Mo Moorman	American football player	7
Dick Todd (ice hockey)	Talk show host	0
Bob Ford (American football)	American football player	7
Alexander Nesmeyanov	Talk show host	0
Pat Sullivan (American football)	American football player	7
Izhar Ashdot	Inventor	0
Ken Greene	American football player	7
Régis de Oliveira	Inventor	0
Frank Beamer	American football player	7
Michael Kidd	Inventor	0
Todd Stroud	American football player	7
V. Balakrishnan (physicist)	Inventor	0
Don Nehlen	American football player	7
John Patrick Hartigan	Inventor	0
Don James (American football)	American football player	7
A. P. J. Abdul Kalam	Inventor	0
John Herrnstein	American football player	7
Kristen Connolly	Inventor	0
Fred Akers	American football player	7
Louis Lomax	Inventor	0
Bill Mohn	American football player	7
Olle Adolphson	Inventor	0
Jeff Cravath	American football player	7
Goshi Hosono	Inventor	0
Reggie Barlow	American football player	7
Shao Mi	Surveyor	0
Dainard Paulson	American football player	7
Daniel Parke	Surveyor	0
Michael Timpson	American football player	7
Fedir Bohatyrchuk	Surveyor	0
Mike Cofer (kicker)	American football player	7
Øyvind Staveland	Surveyor	0
Taurean Henderson	American football player	7
Philip D'Arcy Hart	Surveyor	0
Jackie Sherrill	American football player	7
Alan Bleasdale	Surveyor	0
Tim Brewster	American football player	7
Emmanuel Joseph Sieyès	Surveyor	0
Mike Washington	American football player	7
Sofia Assefa	Surveyor	0
Frank Tavani	American football player	7
Heidi Ettinger	Surveyor	0
Bob Woodruff (American football)	American football player	7
Pat Combs	Surveyor	0
Brice Taylor	American football player	7
Craig Anton	Tennis player	0
Norm Ellenberger	American football player	7
Mbongeni Ngema	Tennis player	0
Larry Carwell	American football player	7
Pyotr Grigorenko	Tennis player	0
Woody Hayes	American football player	7
Malcolm Terris	Tennis player	0
George Cafego	American football player	7
Louis De Geer (1587–1652)	Tennis player	0
Darryl Rogers	American football player	7
Albert Einstein	Tennis player	0
George Tarasovic	American football player	7
Jo Sung-ha	Tennis player	0
Tom Stincic	American football player	7
Christian Sivebæk	Tennis player	0
Lamont Brightful	American football player	7
Masaaki Nakagawa	Tennis player	0
Calvin Lowry	American football player	7
Robert Empie Rogers	Tennis player	0
Marty Schaetzle	American football player	7
Christian Bethancourt	Barrister	0
Jack Gotta	American football player	7
Helli Louise	Barrister	0
Mike Woodley	American football player	7
Neville Brand	Barrister	0
Harry Jacobs (American football)	American football player	7
Shane Howard	Barrister	0
Joe Arenas	American football player	7
Adam Hollander	Barrister	0
Willie Heston	American football player	7
Dario Argento	Barrister	0
Joe Kopcha	American football player	7
Myra Hemmings	Barrister	0
Tony McGee (tight end)	American football player	7
Stefano Okaka	Barrister	0
Keena Turner	American football player	7
Phil Tomney	Barrister	0
Johnny Lattner	American football player	7
Edward Scicluna	Barrister	0
Keith Molesworth	American football player	7
Abraham González (governor)	Pianist	0
Bo Jackson	American football player	7
Travers Humphreys	Pianist	0
Ossie Orwoll	American football player	7
Hánier Dranguet	Pianist	0
Ken Avery	American football player	7
Dan Pasqua	Pianist	0
Ron Sellers	American football player	7
Yue Minjun	Pianist	0
Erk Russell	American football player	7
Lyn Lifshin	Pianist	0
Greg Sampson	American football player	7
Keith E. Haynes	Pianist	0
Doug Nussmeier	American football player	7
Knox Manning	Pianist	0
Dewey Bohling	American football player	7
Greg Francis	Pianist	0
George Svendsen	American football player	7
Evan Crawford (baseball)	Pianist	0
Nate Jackson	American football player	7
Bert Lytell	Record producer	0
Steve Kenney	American football player	7
Dean Ryan	Record producer	0
Victor Santa Cruz	American football player	7
Alan Cowley	Record producer	0
Jim Lambright	American football player	7
Rodrigo Cuevas	Record producer	0
Ray Alborn	American football player	7
Mario Harte	Record producer	0
Patrick Nix	American football player	7
Anton Rodgers	Record producer	0
Richard Collier	American football player	7
Cassim Chilumpha	Record producer	0
Daniel Bullocks	American football player	7
Julia Caba Alba	Record producer	0
Johnny Rembert	American football player	7
Sunny Singh (cricketer)	Record producer	0
Quinn Ojinnaka	American football player	7
Terry Pettus	Record producer	0
Tom Williams (American football)	American football player	7
Bede Durbidge	Baseball player	0
Blaise Winter	American football player	7
Yoandri Betanzos	Baseball player	0
Dale Meinert	American football player	7
Enda Bonner	Baseball player	0
Joe Lee Dunn	American football player	7
Robbie Laing	Baseball player	0
Nick Campofreda	American football player	7
Sophie Tolstoy	Baseball player	0
Vance Johnson	American football player	7
Nikola Vaptsarov	Baseball player	0
Monk Bonasorte	American football player	7
Cheri Oteri	Baseball player	0
Fred Hill (American football)	American football player	7
Kana Tachibana	Baseball player	0
Charlie Strong	American football player	7
Danny Julian Boggs	Baseball player	0
Ray Goff	American football player	7
Xander de Buisonjé	Baseball player	0
Wade Davis	American football player	7
Nick Herbert (physicist)	Philosopher	0
Mark Stoops	American football player	7
Rick Stokes	Philosopher	0
Brett Faryniarz	American football player	7
Terry Smiljanich	Philosopher	0
Bernard Clark	American football player	7
Héctor Melesio Cuén Ojeda	Philosopher	0
Werner L. Maier	American football player	7
Andrew Bowler	Philosopher	0
Warren Holloway	American football player	7
Fan Li	Philosopher	0
Frankie Albert	American football player	7
Daphne Walker (singer)	Philosopher	0
Doug Marsh	American football player	7
Marjorie Sewell Cautley	Philosopher	0
Marquez Pope	American football player	7
Augustus Farnham	Philosopher	0
Maurice Britt	American football player	7
Teresa Forcades	Philosopher	0
Terry Shea	American football player	7
Santiago Phelan	Lifeguard	0
Steve Stripling	American football player	7
Susmit Bose	Lifeguard	0
Phil Bengtson	American football player	7
Amadou Toumani Touré	Lifeguard	0
Paul Guidry	American football player	7
William T. "Bill" Hanna	Lifeguard	0
Jim Laughlin	American football player	7
Dakin Matthews	Lifeguard	0
Gus Malzahn	American football player	7
Makenzie Vega	Lifeguard	0
Wally Hilgenberg	American football player	7
Jess Willard	Lifeguard	0
Bake Turner	American football player	7
Joseph P. Iddings	Lifeguard	0
Johnny Hector	American football player	7
Jack Chapman	Lifeguard	0
Mike Hart (American football)	American football player	7
Kujira	Lifeguard	0
Mal Aldrich	American football player	7
Roger Perry	Violinist	0
Neal Brown	American football player	7
Gabriella Licudi	Violinist	0
Jim Collins (American football coach)	American football player	7
Shakti Gawain	Violinist	0
Dan McGugin	American football player	7
Raymond Ranjeva	Violinist	0
Wilmeth Sidat-Singh	American football player	7
Nigel Noble	Violinist	0
David Rader	American football player	7
Laureen Nussbaum	Violinist	0
Paul Haynes (American football)	American football player	7
George Richard Marek	Violinist	0
Craig Wolfley	American football player	7
Fahad Al-Muwallad	Violinist	0
Lance Leipold	American football player	7
Willy Will	Violinist	0
Nobby Wirkowski	American football player	7
Rinaldo Williams	Violinist	0
Bobby Ross	American football player	7
Betty Holberton	Physicist	0
Dave Osborn	American football player	7
Joan Abelove	Physicist	0
Wendell Tyler	American football player	7
John Stankevitch	Physicist	0
Dick Farley	American football player	7
Matthew White (rugby league)	Physicist	0
Mike Scurlock	American football player	7
Julia Pardoe	Physicist	0
Michael Irvin	American football player	7
John W. Dwinelle	Physicist	0
Chris Cosh	American football player	7
Richard James Morrison	Physicist	0
Major Applewhite	American football player	7
Dhoruba al-Mujahid bin Wahad	Physicist	0
Tim McKyer	American football player	7
Will Grigsby	Physicist	0
Harry McChesney	American football player	7
Hicham Aboucherouane	Physicist	0
Danny Ford	American football player	7
Debra Winger	Basketball player	0
John Pont	American football player	7
Hamsalekha	Basketball player	0
Jason Gesser	American football player	7
Howell Edmunds Jackson	Basketball player	0
Bill Davidson (American football)	American football player	7
Sara Lee Kessler	Basketball player	0
Kurt Kittner	American football player	7
Júlíus Kemp	Basketball player	0
Frank Leahy	American football player	7
James G. MacKinnon	Basketball player	0
Daryl Dickey	American football player	7
Susan Ahn Cuddy	Basketball player	0
Beattie Feathers	American football player	7
Emily Hahn	Basketball player	0
Tunch Ilkin	American football player	7
George Johnson (writer)	Basketball player	0
Kyle Brady	American football player	7
Søren Spanning	Basketball player	0
Justin Armour	American football player	7
Soo Garay	Astronaut	0
Dave Bernard (American football)	American football player	7
Michael Winter (writer)	Astronaut	0
Jack Chevigny	American football player	7
Duane Ferrell	Astronaut	0
Will Muschamp	American football player	7
Steven Sametz	Astronaut	0
Tim Green	American football player	7
Michelle Gordon	Astronaut	0
John Barnhill (American football)	American football player	7
Peter of Capua	Astronaut	0
Dan Devine	American football player	7
Steven Kirby	Astronaut	0
Tom Harmon	American football player	7
Yin Jian	Astronaut	0
James Phelan (American football)	American football player	7
Ruth Hart	Astronaut	0
Francis Schmidt	American football player	7
Bob Moose	Astronaut	0
Ron Gould (American football)	American football player	7
Natalia Sánchez (actress)	Friar	0
Jack Leavenworth	American football player	7
Anoushey Ashraf	Friar	0
Scott Frost	American football player	7
Lea De Mae	Friar	0
Greasy Neale	American football player	7
Ukichiro Nakaya	Friar	0
Junkyard Dog	American football player	7
Maury Ginsberg	Friar	0
Jim Ringo	American football player	7
Nebojša Todorović	Friar	0
Don Read	American football player	7
Mike Vrabel	Friar	0
Larry Whigham	American football player	7
Dumarsais Simeus	Friar	0
Fred Jackson (American football coach)	American football player	7
Colby Ward	Friar	0
Thomas Brezina	Presenter	7
Enrique Bátiz Campbell	Friar	0
Jerry Hodak	Meteorologist	7
Stefan (bishop of Płock)	Television Show Host	0
Susan Rook	Talk show host	7
Klaas de Vries (Christian Democratic Appeal)	Television Show Host	0
Sisca Jessica	Talk show host	7
Giorgos Koltzos	Television Show Host	0
Calvin Souther Fuller	Inventor	7
Kevin Parienté	Television Show Host	0
William Symonds	Surveyor	7
Elin Rubensson	Television Show Host	0
George Everest	Surveyor	7
Tim Dorsey	Television Show Host	0
Alina Jidkova	Tennis player	7
Orovida Camille Pissarro	Television Show Host	0
Oscar Wegner	Tennis player	7
Gus Creely	Television Show Host	0
Bill Shipsey	Barrister	7
Cornelius Darragh	Television Show Host	0
Pascal Mailloux	Pianist	7
Hossam Ghaly	Television Show Host	0
Lillian McMurry	Record producer	7
James Bunten	Television director	0
Tom Werman	Record producer	7
Grayson Boucher	Television director	0
Nesuhi Ertegun	Record producer	7
Louis A. Kaiser	Television director	0
Bob Weinstock	Record producer	7
Trevor MacGregor	Television director	0
Frank Wilson (musician)	Record producer	7
Gurbanmyrat Ataýew	Television director	0
Clarence Paul	Record producer	7
Vladimir Semichastny	Television director	0
Kissy Sell Out	Record producer	7
David King Udall	Television director	0
Nat Powers	Record producer	7
Herbert Henry Gatenby Moody	Television director	0
Freddy DeMann	Record producer	7
Dmitrii Kokarev	Television director	0
Wolfgang Boss	Record producer	7
Sergo Zakariadze	Television director	0
Mickie Most	Record producer	7
Scott Frandsen	Psychiatrist	0
Camille Purcell	Record producer	7
Karin Knapp	Psychiatrist	0
Carl Jefferson	Record producer	7
Roger Woolger	Psychiatrist	0
David Chesky	Record producer	7
Jeff Kanipe	Psychiatrist	0
William Weatherspoon	Record producer	7
Cy Grant	Psychiatrist	0
Eric Vloeimans	Record producer	7
Kazem Rajavi	Psychiatrist	0
MC Zwieback	Record producer	7
Catharina Bråkenhielm	Psychiatrist	0
Bob Keane	Record producer	7
Jessica Knappett	Psychiatrist	0
Danny Tate	Record producer	7
Espinoza Paz	Psychiatrist	0
Brian Hood	Record producer	7
Tewfik Saleh	Psychiatrist	0
Joe Carducci	Record producer	7
Arthur Morrison	Theatrical producer	0
Mike Berniker	Record producer	7
Charles Henry Crandall	Theatrical producer	0
Manuel Cueto	Baseball player	7
Robert Carr, 1st Earl of Somerset	Theatrical producer	0
Ron Fairly	Baseball player	7
Takashi Tanihata	Theatrical producer	0
Todd Dunwoody	Baseball player	7
Harold Arthur Poling	Theatrical producer	0
Mike Milosevich	Baseball player	7
Sisowath Monireth	Theatrical producer	0
George Strickland (baseball)	Baseball player	7
Idrissa Coulibaly	Theatrical producer	0
Billy Maharg	Baseball player	7
John N. Hagan	Theatrical producer	0
Pop Smith	Baseball player	7
Amitoze Singh	Theatrical producer	0
George Arias	Baseball player	7
Larry Mendte	Theatrical producer	0
Dutch Meier	Baseball player	7
Otto Harbach	Illustrator	0
Kurt Bevacqua	Baseball player	7
Anthony Drewe	Illustrator	0
Ricky Otero	Baseball player	7
Pedro Tiba	Illustrator	0
Marv Goodwin	Baseball player	7
Brian McCardie	Illustrator	0
Rube Schauer	Baseball player	7
Pietro Colonna	Illustrator	0
Gene Tenace	Baseball player	7
Nikša Dobud	Illustrator	0
Pat Rooney	Baseball player	7
Kenneth Francis Ripple	Illustrator	0
Brian Dallimore	Baseball player	7
Jordan Todorov	Illustrator	0
Don Secrist	Baseball player	7
Lisa Robertson	Illustrator	0
Del Unser	Baseball player	7
Ted Nebbeling	Illustrator	0
Jon Ratliff	Baseball player	7
Denyse Tontz	Novelist	0
Darrell Einertson	Baseball player	7
Nancy Kricorian	Novelist	0
Nick Koback	Baseball player	7
Pat Howard	Novelist	0
Dick Drott	Baseball player	7
Jaro Deppe	Novelist	0
Jay Kleven	Baseball player	7
Murray Gershenz	Novelist	0
Hack Eibel	Baseball player	7
Emilio Ambrosini	Novelist	0
Sean Berry	Baseball player	7
Mundell Lowe	Novelist	0
Roxy Snipes	Baseball player	7
Yancey Thigpen	Novelist	0
Dave Nilsson	Baseball player	7
Sylvain Legwinski	Novelist	0
Marshall Brant	Baseball player	7
John Seabrook	Novelist	0
John Caneira	Baseball player	7
Adam Clayton Powell, Jr.	Teacher	0
Ham Wade	Baseball player	7
Christine Sonali Merrill	Teacher	0
Bill Burns (baseball)	Baseball player	7
Michael Murphy (author)	Teacher	0
Tetsuya Utsumi	Baseball player	7
Simona Molinari	Teacher	0
Dots Miller	Baseball player	7
Alexander Uninsky	Teacher	0
Bob Roselli	Baseball player	7
Ron Norsworthy	Teacher	0
Marcus Moore	Baseball player	7
Peter Mel	Teacher	0
Mike Bovee	Baseball player	7
Fabián Bordagaray	Teacher	0
Swat McCabe	Baseball player	7
Johan Friggeråker	Teacher	0
C. V. Matteson	Baseball player	7
Gordon Rigby	Teacher	0
Raul Casanova	Baseball player	7
Bryan Magee	Prophet	0
Leon Culberson	Baseball player	7
Quincy Howe	Prophet	0
Link Wasem	Baseball player	7
Lupe Gigliotti	Prophet	0
Art Rico	Baseball player	7
Lukwesa Burak	Prophet	0
Ching-Ming Wang	Baseball player	7
Angelien Eijsink	Prophet	0
Kelly Johnson (baseball)	Baseball player	7
Bainbridge Bunting	Prophet	0
Shinnosuke Abe	Baseball player	7
John Zachman	Prophet	0
Art Allison	Baseball player	7
Bill Conner	Prophet	0
Jim Dorsey	Baseball player	7
Are Strandli	Prophet	0
Doc Powers	Baseball player	7
John W. Weeks	Prophet	0
Keith Kessinger	Baseball player	7
Adolpho Washington	Explorer	0
Al Gionfriddo	Baseball player	7
Ellen Perry	Explorer	0
Jerry Garvin	Baseball player	7
Richard Woodman	Explorer	0
Joe Orsulak	Baseball player	7
Pierre Lhande	Explorer	0
Damon Mashore	Baseball player	7
Ayesha Dharker	Explorer	0
Félix Mantilla (baseball)	Baseball player	7
Chen Li-an	Explorer	0
Denny Hocking	Baseball player	7
Suresh Chandra Menon	Explorer	0
Víctor Rosario	Baseball player	7
Patience Wheatcroft, Baroness Wheatcroft	Explorer	0
Takahito Kudo	Baseball player	7
Adam de la Peña	Explorer	0
Buck Stanton	Baseball player	7
Werner Otto (entrepreneur)	Explorer	0
Taketoshi Gotoh	Baseball player	7
Mark Taylor (racing driver)	Preacher	0
Jiggs Parrott	Baseball player	7
Nikolay Mitrofanovich Krylov	Preacher	0
Rip Hagerman	Baseball player	7
Ken Norton, Jr.	Preacher	0
Earl Averill	Baseball player	7
Diletta Carli	Preacher	0
Spencer Adams	Baseball player	7
Peter Rinearson	Preacher	0
Shaun Fitzmaurice	Baseball player	7
Abijah Mann, Jr.	Preacher	0
Howard Freigau	Baseball player	7
Steve Miller (musician)	Preacher	0
Tony Álvarez	Baseball player	7
Jason Frederick	Preacher	0
Steve Lyons (baseball)	Baseball player	7
Tammy Duckworth	Preacher	0
Jack Rothrock	Baseball player	7
Rannveig Guðmundsdóttir	Preacher	0
Manny Seoane	Baseball player	7
Zaher Farid Al-Fadhli	Attorneys in the United States	0
Harry Colliflower	Baseball player	7
Lawrence Dane	Attorneys in the United States	0
Walt Irwin	Baseball player	7
Francesca Martiradonna	Attorneys in the United States	0
Craig Smajstrla	Baseball player	7
Zdeněk Kalista	Attorneys in the United States	0
Tug Thompson	Baseball player	7
Humberto Benítez Treviño	Attorneys in the United States	0
Jim Chamblee	Baseball player	7
Jean-Claude Boulanger	Attorneys in the United States	0
Skippy Roberge	Baseball player	7
Babrik Shah	Attorneys in the United States	0
Denny Williams	Baseball player	7
Ernest Delaney	Attorneys in the United States	0
Gabe White	Baseball player	7
David Gordon (software entrepreneur)	Attorneys in the United States	0
Bill Roman	Baseball player	7
Vyacheslav Zudov	Attorneys in the United States	0
Max Patkin	Baseball player	7
Ian Oswald Liddell	Merchant	0
Mark Lemke	Baseball player	7
Christian Schad	Merchant	0
Dennis Sherrill	Baseball player	7
Garry Galley	Merchant	0
Tom Cheney (baseball)	Baseball player	7
Alfred Leland Crabb	Merchant	0
Art Bader	Baseball player	7
Sándor Simonyi-Semadam	Merchant	0
Red Bluhm	Baseball player	7
Steven Berkoff	Merchant	0
Rich Aude	Baseball player	7
A. David Buckingham	Merchant	0
George Quellich	Baseball player	7
David J. Burke	Merchant	0
Duff Brumley	Baseball player	7
William Hallock Park	Merchant	0
Clarence Kraft	Baseball player	7
Brian Beacock	Merchant	0
Jim Bronstad	Baseball player	7
John Kerry	Impresario	0
Terry Shumpert	Baseball player	7
Marianne Jelved	Impresario	0
Doug Loman	Baseball player	7
María Barranco	Impresario	0
Carl Yastrzemski	Baseball player	7
Nik Novecento	Impresario	0
Rich DeLucia	Baseball player	7
Haruka Ayase	Impresario	0
Grant Dunlap	Baseball player	7
David M. Harper	Impresario	0
Darron Cox	Baseball player	7
Natasha Sharma	Impresario	0
Wally Holborow	Baseball player	7
Christian Poulsen	Impresario	0
Steve Hertz (third baseman)	Baseball player	7
Thomas Gault	Impresario	0
Rob Sasser	Baseball player	7
Alexander Peacock	Impresario	0
Bert Griffith	Baseball player	7
Tomáš Klobučník	Costume Designer	0
Kim Batiste	Baseball player	7
Jefferson Hall (actor)	Costume Designer	0
Chris Coletta	Baseball player	7
Vedavalli	Costume Designer	0
Dick Lange	Baseball player	7
Murph (drummer)	Costume Designer	0
Tim O'Rourke	Baseball player	7
W. G. Snuffy Walden	Costume Designer	0
Gene Leek	Baseball player	7
Helen Page Camp	Costume Designer	0
Ace Stewart	Baseball player	7
José Cláudio Ribeiro da Silva	Costume Designer	0
Jay Aldrich	Baseball player	7
Anton Djupvik	Costume Designer	0
Wayne Gross	Baseball player	7
Brian Morton (Scottish writer)	Costume Designer	0
Brian Koelling	Baseball player	7
Thierry Lhermitte	Costume Designer	0
Lou Paul	Baseball player	7
Connie Eaton	Fisherman	0
Bill Batsch	Baseball player	7
Nilla Fischer	Fisherman	0
Rick Camp	Baseball player	7
Red Worthington	Fisherman	0
Roger Marquis	Baseball player	7
Blaž Rola	Fisherman	0
Harry Krause	Baseball player	7
László Almásy	Fisherman	0
Al Hrabosky	Baseball player	7
Steve O'Neill	Fisherman	0
Pete Falsey	Baseball player	7
Jon Dough	Fisherman	0
Duff Cooley	Baseball player	7
Michał Klepfisz	Fisherman	0
Otto Vogel	Baseball player	7
Joe Dowell	Fisherman	0
Steve Roser	Baseball player	7
George Fallon (baseball)	Fisherman	0
Kelvin Chapman	Baseball player	7
John Studd (gynaecologist)	Bassist	0
Matías Carrillo	Baseball player	7
Kirk McLean	Bassist	0
Mike Zunino	Baseball player	7
Ralf Metzenmacher	Bassist	0
Forrest More	Baseball player	7
Antônio de Queirós Teles, Baron of Jundiaí	Bassist	0
Art Hagan	Baseball player	7
Nathaniel Branden	Bassist	0
Gordon Massa	Baseball player	7
Teresa Castillo	Bassist	0
Turkey Tyson	Baseball player	7
Cochi Ponzoni	Bassist	0
Tim Olson	Baseball player	7
Waltraut Haas	Bassist	0
Steve Rain	Baseball player	7
Ghassan Afiouni	Bassist	0
John Matias	Baseball player	7
Beatrix Hamburg	Bassist	0
Chet Hajduk	Baseball player	7
Alexandre Hardy	Tutor	0
Alan Storke	Baseball player	7
Trevor May	Tutor	0
Edgar Cáceres	Baseball player	7
Granit Xhaka	Tutor	0
Chiang Chih-Hsien	Baseball player	7
Carl Wickland	Tutor	0
Steve Eddy	Baseball player	7
Moritz Eggert	Tutor	0
Dave Sax	Baseball player	7
Syd Saylor	Tutor	0
Ramón López (baseball)	Baseball player	7
Kara Hultgreen	Tutor	0
Brad Rigby	Baseball player	7
Máiréad Ní Ghráda	Tutor	0
Johnny Scalzi	Baseball player	7
Javier Vázquez	Tutor	0
Jack Radtke	Baseball player	7
Jerzy Pichelski	Tutor	0
Dick Egan (pitcher)	Baseball player	7
Chris Roberson (author)	Tentmaker	0
Jeff Burroughs	Baseball player	7
Henrique Teixeira de Sousa	Tentmaker	0
José Vizcaíno	Baseball player	7
Gian Maria Volonté	Tentmaker	0
Boyd Bartley	Baseball player	7
Blake Austin	Tentmaker	0
Chuck Knoblauch	Baseball player	7
Eric Loren	Tentmaker	0
Russ Snyder	Baseball player	7
Boris Kagarlitsky	Tentmaker	0
Jeff Grotewold	Baseball player	7
Tony Reed	Tentmaker	0
Walt Terrell	Baseball player	7
John Francis Hackett	Tentmaker	0
Dick McBride	Baseball player	7
Steve Hanft	Tentmaker	0
Jack Remsen	Baseball player	7
Edmund De Wind	Tentmaker	0
Bobby Fenwick	Baseball player	7
Yenebier Guillén	Guitarist	0
Mark Lukasiewicz	Baseball player	7
DJ Skribble	Guitarist	0
Don Hoak	Baseball player	7
George Deacon (civil engineer)	Guitarist	0
Art Ball	Baseball player	7
Pedro Vuskovic	Guitarist	0
Luis Aguayo	Baseball player	7
Paul Desmond	Guitarist	0
Charlie Starr	Baseball player	7
Linwood Barclay	Guitarist	0
Wayne Ambler	Baseball player	7
Rima Maktabi	Guitarist	0
Larry Sutton	Baseball player	7
Benjamin Chew Tilghman	Guitarist	0
Del Howard	Baseball player	7
Michelle Lang	Guitarist	0
Ed Walczak	Baseball player	7
Carl Fogarty	Guitarist	0
Manabu Iwadate	Baseball player	7
Frank Minnifield	Diplomat	0
Al Gould	Baseball player	7
David Edelstein	Diplomat	0
Luis Pineda	Baseball player	7
Patrick Coghlan	Diplomat	0
Tun Berger	Baseball player	7
Trish Bertram	Diplomat	0
Tim McKeithan	Baseball player	7
Nena Danevic	Diplomat	0
Phil Plantier	Baseball player	7
Oleg Bogomolov	Diplomat	0
Andy McGaffigan	Baseball player	7
Lenka Radová	Diplomat	0
Mike Saipe	Baseball player	7
Joy Fawcett	Diplomat	0
Ray Boone	Baseball player	7
Anthonique Strachan	Diplomat	0
Tony Curry	Baseball player	7
Morris Unutoa	Diplomat	0
Dave Birdsall	Baseball player	7
Helen Dunmore	Performance Artist	0
Steve Soderstrom	Baseball player	7
Turk Farrell	Performance Artist	0
Chris Nichting	Baseball player	7
Pete Chilcutt	Performance Artist	0
Denny Walling	Baseball player	7
Munchi (DJ)	Performance Artist	0
Lou Merloni	Baseball player	7
Nick Mowrer	Performance Artist	0
Alamazoo Jennings	Baseball player	7
Charles Gore (artist)	Performance Artist	0
Lou Rosenberg	Baseball player	7
Kevin Phillips (actor)	Performance Artist	0
Mickey Harrington	Baseball player	7
Gherman Titov	Performance Artist	0
Heath Murray	Baseball player	7
Dutch Clark	Performance Artist	0
Johnny Sturm	Baseball player	7
Vladimir Petrov (director)	Performance Artist	0
George Stumpf	Baseball player	7
Duane Akina	Polymath	0
Scott Fletcher (baseball)	Baseball player	7
Blayne Wilson	Polymath	0
Dave Telgheder	Baseball player	7
Ian Halperin	Polymath	0
Bob Skube	Baseball player	7
Constance Carrier	Polymath	0
Tim Drew	Baseball player	7
Al Pierotti	Polymath	0
Sparky Adams	Baseball player	7
Viktor Orbán	Polymath	0
Cotton Knaupp	Baseball player	7
Edwin Almonte	Polymath	0
Doc Amole	Baseball player	7
Fang Shu	Polymath	0
Hiroshi Hirao	Baseball player	7
Harold A. Zahl	Polymath	0
Larry Milbourne	Baseball player	7
Ryan Fraser	Polymath	0
Jeff Huson	Baseball player	7
Izale McLeod	Radio producer	0
Rick Surhoff	Baseball player	7
Mauri Pekkarinen	Radio producer	0
Ernie Gust	Baseball player	7
Percy W. Griffiths	Radio producer	0
Olmedo Sáenz	Baseball player	7
Jack Grayson	Radio producer	0
Jamie Brewington	Baseball player	7
Sam Chatmon	Radio producer	0
Kid Camp	Baseball player	7
Praga Khan	Radio producer	0
Roberto Alomar	Baseball player	7
Jamel Herring	Radio producer	0
Dan Perkins (baseball)	Baseball player	7
John Wesley Shipp	Radio producer	0
Greg Tubbs	Baseball player	7
Tong Dizhou	Radio producer	0
Arden Eddie	Baseball player	7
Martha Wilson	Radio producer	0
Mark McLemore	Baseball player	7
Ram Pothineni	Voice Actor	0
Rubén Rivera	Baseball player	7
Tom Schmitz	Voice Actor	0
Neil Fiala	Baseball player	7
Nenad Beđik	Voice Actor	0
Dick Tidrow	Baseball player	7
Mathias Klotz	Voice Actor	0
Wally Kopf	Baseball player	7
John P. Costas (business)	Voice Actor	0
Jake Knowdell	Baseball player	7
Massimo Mannelli	Voice Actor	0
Steve Gibralter	Baseball player	7
Paul Tishman	Voice Actor	0
Fred Clarke	Baseball player	7
Valérie Kaprisky	Voice Actor	0
Champ Summers	Baseball player	7
Jack J. Grynberg	Voice Actor	0
Shane Bowers	Baseball player	7
Lindsay Hoyle	Voice Actor	0
Billy Shantz	Baseball player	7
Irene Papas	Theatre Director	0
Luis Isaac	Baseball player	7
Sonny Burgess	Theatre Director	0
Mickey Haslin	Baseball player	7
Dick MacPherson	Theatre Director	0
Clint Sodowsky	Baseball player	7
Paul Bryan	Theatre Director	0
Eddie Edmonson	Baseball player	7
Dirk van den Berg	Theatre Director	0
Scott Seabol	Baseball player	7
Robert Kotei	Theatre Director	0
Rip Coleman	Baseball player	7
Harry Vandiver	Theatre Director	0
Scotty Alcock	Baseball player	7
Sérgio Jimenez	Theatre Director	0
Harry Cheek	Baseball player	7
Gordon Richardson, Baron Richardson of Duntisbourne	Theatre Director	0
Takayuki Terauchi	Baseball player	7
Michael Lazarovitch	Theatre Director	0
Doug Capilla	Baseball player	7
Keith Murray (rapper)	Bandleader	0
Pat Pacillo	Baseball player	7
Jörg Zander	Bandleader	0
Steve Pegues	Baseball player	7
Janet Henderson	Bandleader	0
Ron Stillwell	Baseball player	7
Ron McGovney	Bandleader	0
Buddy Hassett	Baseball player	7
Charo López	Bandleader	0
George Aiton	Baseball player	7
Brian Lanker	Bandleader	0
Van Kelly	Baseball player	7
Allison Keith	Bandleader	0
Andy Kosco	Baseball player	7
Marc Gracie	Bandleader	0
Tom Grieve	Baseball player	7
Molly Adair	Bandleader	0
Kensuke Uchimura	Baseball player	7
Kathleen Chalfant	Bandleader	0
Ed Delahanty	Baseball player	7
Shikao Ikehara	Roman emperor	0
Al Chambers	Baseball player	7
Robin Cocks	Roman emperor	0
Cal Abrams	Baseball player	7
Lucio Godoy	Roman emperor	0
Ian Hart	Philosopher	7
Todd Hiett	Roman emperor	0
Judianna Makovsky	Philosopher	7
Gregory Allen Howard	Roman emperor	0
Sediq Afghan	Philosopher	7
Eleni Menegaki	Roman emperor	0
Leonora Speyer	Violinist	7
Oleg Strizhenov	Roman emperor	0
Phil Chenier	Basketball player	7
Anne Consigny	Roman emperor	0
Vytenis Lipkevičius	Basketball player	7
Grzegorz Ciechowski	Roman emperor	0
Allen Crabbe	Basketball player	7
Charlie Rhindress	Roman emperor	0
Evgeniya Belyakova	Basketball player	7
Hedley Bunton	Biologist	0
Samuel Dalembert	Basketball player	7
Mauro Di Pasquale	Biologist	0
Earl Calloway	Basketball player	7
Don Adams (boxer)	Biologist	0
Micheal Williams	Basketball player	7
Paul L. Modrich	Biologist	0
Jimmer Fredette	Basketball player	7
Algernon Frederick Rous de Horsey	Biologist	0
Lester Hudson	Basketball player	7
Jouni Inkala	Biologist	0
Isaiah Thomas (basketball)	Basketball player	7
Miloš Krkotić	Biologist	0
Tyreke Evans	Basketball player	7
Jean-Louis Curtis	Biologist	0
Ronnie Price	Basketball player	7
Armando Marsans	Biologist	0
Philip Cezar	Basketball player	7
Eugenio Batres Garcia	Biologist	0
Ding Jinhui	Basketball player	7
Jim MacMurdo	Artist	0
Ersan İlyasova	Basketball player	7
Dave Morris (writer)	Artist	0
Randy Foye	Basketball player	7
Chris Hogg	Artist	0
Steve Blake	Basketball player	7
Daniel Westphal	Artist	0
Eric Menk	Basketball player	7
Kenneth Binks	Artist	0
Marouan Laghnej	Basketball player	7
Bartholomeus Breenbergh	Artist	0
Terry Cummings	Basketball player	7
William A. Hurley	Artist	0
Skylar Diggins	Basketball player	7
Amy Gibson	Artist	0
Matt Barnes	Basketball player	7
Nelson Freire	Artist	0
Kaloyan Ivanov	Basketball player	7
Elena Khrustaleva	Artist	0
Reggie Bullock	Basketball player	7
Juanita Reina	Entertainer	0
Wesley Johnson (basketball)	Basketball player	7
Jim Supangkat	Entertainer	0
Kyrie Irving	Basketball player	7
Paul Petard	Entertainer	0
Ronald Murray	Basketball player	7
Bernard Stevens	Entertainer	0
Bernard James	Basketball player	7
Simran Sethi	Entertainer	0
Marcelinho Huertas	Basketball player	7
Raymond J. Smith	Entertainer	0
Cemal Nalga	Basketball player	7
Henry William Bristow	Entertainer	0
Troy Daniels	Basketball player	7
Erich Leinsdorf	Entertainer	0
Mark Strickland	Basketball player	7
Jessie Wallace	Entertainer	0
Edo Murić	Basketball player	7
Yevgeniy Yevstigneyev	Entertainer	0
Dennis Rodman	Basketball player	7
Krsto Papić	Political Activist	0
Beno Udrih	Basketball player	7
Jerod Mixon	Political Activist	0
LeBron James	Basketball player	7
Joaquín Martínez	Political Activist	0
George Gervin	Basketball player	7
Zhang Guowei (high jumper)	Political Activist	0
Nick Van Exel	Basketball player	7
Miron Bleiberg	Political Activist	0
Enes Kanter	Basketball player	7
Letícia Persiles	Political Activist	0
Allan Houston	Basketball player	7
Felix Grundy	Political Activist	0
Emir Preldžić	Basketball player	7
Milt Scott	Political Activist	0
Josh Shipp (basketball)	Basketball player	7
Alain Tanner	Political Activist	0
Alex Len	Basketball player	7
Robert Jarvis Cochran Walker	Political Activist	0
Vergel Meneses	Basketball player	7
Michael Morse (skier)	Critic	0
Nikola Peković	Basketball player	7
Emmanuel Pío	Critic	0
Ali Doraghi	Basketball player	7
Floyd Dunn	Critic	0
Kalin Lucas	Basketball player	7
James B. Howell	Critic	0
Nikola Mirotić	Basketball player	7
Gregor Strniša	Critic	0
Rafael Addison	Basketball player	7
Esaias Tegnér	Critic	0
Jacque Vaughn	Basketball player	7
John Wheatley (physicist)	Critic	0
Lindsay Whalen	Basketball player	7
Doug Dennison	Critic	0
Danilo Gallinari	Basketball player	7
Samuel Benchetrit	Critic	0
Fabien Causeur	Basketball player	7
Jason Gould	Critic	0
DeQuan Jones	Basketball player	7
Kanichi Kurita	Physician	0
David Lee (basketball)	Basketball player	7
Clif Richardson	Physician	0
Bernard King	Basketball player	7
Paul McDowell (actor)	Physician	0
Khalid El-Amin	Basketball player	7
Mike Livingston (rower)	Physician	0
Ermal Kuqo	Basketball player	7
Preslava	Physician	0
Robbie Hummel	Basketball player	7
Ku Hye-sun	Physician	0
Adrian Griffin	Basketball player	7
Mansoor bin Tahnoon Al Nahayan	Physician	0
Jordan Farmar	Basketball player	7
Daphne Gottlieb	Physician	0
Felton Spencer	Basketball player	7
Mikhail Kukushkin	Physician	0
Andrew Lawrence (basketball)	Basketball player	7
Viola Tree	Physician	0
Leo Isaac	Basketball player	7
Jane Suuto	Fashion Model	0
Kostas Sloukas	Basketball player	7
Mohammad Gharib	Fashion Model	0
Tyler Honeycutt	Basketball player	7
Austin Leslie	Fashion Model	0
Mark Caguioa	Basketball player	7
James Koko Lomell	Fashion Model	0
Trey Burke	Basketball player	7
William Murphy (Irish politician)	Fashion Model	0
Ricky Ledo	Basketball player	7
Vaughan Oliver	Fashion Model	0
Rod Brown	Basketball player	7
Jean-Marie Charpentier	Fashion Model	0
Seimone Augustus	Basketball player	7
Perez Morton	Fashion Model	0
Pooh Richardson	Basketball player	7
Pratesh Shirodkar	Fashion Model	0
Kara Lawson	Basketball player	7
F. R. Crawley	Fashion Model	0
Rodney Stuckey	Basketball player	7
Sebastián Prediger	Conservationist	0
Doğuş Balbay	Basketball player	7
Fatima Tabaamrant	Conservationist	0
Al Horford	Basketball player	7
Roger E. Olson	Conservationist	0
Taj Gibson	Basketball player	7
Rasual Butler	Conservationist	0
Shawn Marion	Basketball player	7
Doc Kane	Conservationist	0
Shawn Bradley	Basketball player	7
Jeon Yu-mi	Conservationist	0
Alvin Patrimonio	Basketball player	7
Tommy Maher	Conservationist	0
Érika de Souza	Basketball player	7
Scott Crary	Conservationist	0
Robertas Javtokas	Basketball player	7
Jimena Lindo	Conservationist	0
Devin Harris	Basketball player	7
Han Sunhwa	Conservationist	0
Bo Kimble	Basketball player	7
Julian House	Film Director	0
Corey Maggette	Basketball player	7
Lloyd Doggett	Film Director	0
Jared Cunningham	Basketball player	7
Marie McLaughlin	Film Director	0
Kara Braxton	Basketball player	7
Juan Ignacio Luca de Tena, 2nd Marquis of Luca de Tena	Film Director	0
Donald Sloan (basketball)	Basketball player	7
Ed Pulaski	Film Director	0
Corey Brewer	Basketball player	7
Stan David	Film Director	0
Dorell Wright	Basketball player	7
Bakri Almadina	Film Director	0
Jamal Crawford	Basketball player	7
Michael Armitage (politician)	Film Director	0
Zach Randolph	Basketball player	7
Troy Hambrick	Film Director	0
Jason Terry	Basketball player	7
Mike Büskens	Film Director	0
Luke Ridnour	Basketball player	7
Elizabeth Palmer	Urban planner	0
Brandon Jennings	Basketball player	7
Jamie Dixon	Urban planner	0
José Calderón (basketball)	Basketball player	7
Thérèse Sita-Bella	Urban planner	0
Adrian Dantley	Basketball player	7
Derrick Ham	Urban planner	0
Ricky Pierce	Basketball player	7
Naresh Kumar	Urban planner	0
Paul Gause	Basketball player	7
Stuart M. Gerson	Urban planner	0
Rasheed Wallace	Basketball player	7
Curt Chaplin	Urban planner	0
Kerem Gönlüm	Basketball player	7
Paul Theroux	Urban planner	0
Nate Wolters	Basketball player	7
Halina Auderska	Urban planner	0
Randy Brown	Basketball player	7
George Newell Armsby	Urban planner	0
Aleks Marić	Basketball player	7
Pam Evans	Science writer	0
Stu Lantz	Basketball player	7
Dante Magnani	Science writer	0
Matt Harpring	Basketball player	7
Adine Masson	Science writer	0
Dejan Ivanov	Basketball player	7
Joe Lynch (director)	Science writer	0
Matee Ajavon	Basketball player	7
Hasan Zaglam	Science writer	0
Peter Crawford (basketball)	Basketball player	7
Nils Stensson Sture	Science writer	0
Hassan Whiteside	Basketball player	7
Matthew Scurfield	Science writer	0
Miranda Ayim	Basketball player	7
Mare Dibaba	Science writer	0
Taquan Dean	Basketball player	7
Sibte Hassan	Science writer	0
Ish Smith	Basketball player	7
Robin Hughes	Science writer	0
Kenny Thomas (basketball)	Basketball player	7
J. Eric S. Thompson	Soldier	0
Derrick Chievous	Basketball player	7
Jimi Goodwin	Soldier	0
Nick Young (basketball)	Basketball player	7
Tim Breacker	Soldier	0
Josh McRoberts	Basketball player	7
George Moncur	Soldier	0
Barış Ermiş	Basketball player	7
Lawrence W. Barsalou	Soldier	0
Quincy Acy	Basketball player	7
Raimon	Soldier	0
Teresa Weatherspoon	Basketball player	7
Víctor Ruiz Torre	Soldier	0
Tony Allen (basketball)	Basketball player	7
Robert Rowand Anderson	Soldier	0
Nathan Jawai	Basketball player	7
Sandra Mandir	Soldier	0
Marqus Blakely	Basketball player	7
Mary Ann Childers	Soldier	0
Dionte Christmas	Basketball player	7
Becky Morgan	Composer	0
Dewarick Spencer	Basketball player	7
Mehmet Akif Alakurt	Composer	0
Sharrod Ford	Basketball player	7
Belva Plain	Composer	0
Scott D. Tingle	Astronaut	7
Bruce Crawford	Composer	0
Albert of Stade	Friar	7
Dylan Kerr	Composer	0
Ritesh Batra	Television director	7
Alexander Catcott	Composer	0
Elijah Moshinsky	Television director	7
Adam Liptak	Composer	0
Pedro Orrego	Television director	7
Scott Fulhage	Composer	0
Ali Eisner	Television director	7
Alejandro Martinuccio	Composer	0
Harrison Grey Fiske	Theatrical producer	7
Steve Mesler	Composer	0
Enda Markey	Theatrical producer	7
Joe Strong	Mathematician	0
Draner	Illustrator	7
Fred F. Fielding	Mathematician	0
Christian McGrath	Illustrator	7
Walt Dickson	Mathematician	0
Hayley Hutchinson	Illustrator	7
Franklin Ruehl	Mathematician	0
Nick Percival	Novelist	7
Jesse Eisenberg	Mathematician	0
Ursula Holden-Gill	Teacher	7
Atiye	Mathematician	0
Ellen Thomas (actress)	Teacher	7
Jordi Pujol i Soley	Mathematician	0
Sharon Draper	Teacher	7
Clifford Etienne	Mathematician	0
Lowell Milken	Teacher	7
Jack Rubinacci	Mathematician	0
Orval Prophet	Prophet	7
Ayat Al-Qurmezi	Mathematician	0
Tim Commerford	Prophet	7
Hassan Bubacar Jallow	Racing driver	0
Patrick Jones	Preacher	7
Sharon Maguire	Racing driver	0
Preacher Roe	Preacher	7
Jan Marini	Racing driver	0
Garth Ennis	Preacher	7
Natalya Seleznyova	Racing driver	0
Charles Crosthwaite	Merchant	7
Daniel Edwards	Racing driver	0
Leela Naidu	Merchant	7
Semyon Aranovich Gershgorin	Racing driver	0
Verónica Merchant	Merchant	7
Georges Chaperot	Racing driver	0
Samuel Morgan	Merchant	7
Azmy Mehelba	Racing driver	0
World Famous Bushman	Fisherman	7
Shyam K. Naidu	Racing driver	0
Cevat Şakir Kabaağaçlı	Fisherman	7
Marcia Lewis	Racing driver	0
Mark Deutrom	Bassist	7
Johnny Brown (actor)	Ice hockey player	0
Jorge Pescara	Bassist	7
Eugene Victor Wolfenstein	Ice hockey player	0
Andrew Glyn	Tutor	7
Louis Ginzberg	Ice hockey player	0
Patrick Mullee	Diplomat	7
Wyatt Gooden	Ice hockey player	0
Bridget Kendall	Diplomat	7
Robert H. Scales	Ice hockey player	0
Charles Hill (diplomat)	Diplomat	7
Caroline O'Connor (rower)	Ice hockey player	0
Erasmus Finx	Polymath	7
Jeremy Nicholas (broadcaster)	Ice hockey player	0
Roger Pusey	Radio producer	7
Henry Harrison Culver	Ice hockey player	0
Elliott Lewis (radio)	Radio producer	7
Tyeb Mehta	Ice hockey player	0
Dave Sitek	Radio producer	7
Kalyanasundaranar	Ice hockey player	0
Chris Coady	Radio producer	7
Terry Dunn	Theologian	0
Ira Basen	Radio producer	7
George Pastell	Theologian	0
Oppian	Roman emperor	7
Darian Durant	Theologian	0
Septimius Severus	Roman emperor	7
Jack Simmons (actor)	Theologian	0
Isidore of Chios	Roman emperor	7
Dylan Taite	Theologian	0
Natalya Andrejchenko	Artist	7
Sonya Taaffe	Theologian	0
Yelena Ksenofontova	Artist	7
Fred Wah	Theologian	0
Martin Baum (agent)	Artist	7
Marlon King	Theologian	0
Oksana Bilozir	Artist	7
Kunjikkuttan Thampuran (actor)	Theologian	0
Georgi Vinogradov (tenor)	Artist	7
Thomas Nicoll Hepburn	Theologian	0
Sophie Albert	Artist	7
Theodore Davie	Rodeo clown	0
Galina Vishnevskaya	Artist	7
Reginald Swartz	Rodeo clown	0
Ilya Oleynikov	Artist	7
Elena Baltacha	Rodeo clown	0
Aleksandr Alov	Artist	7
Phil Nibbelink	Rodeo clown	0
Nikolai Pozdneev	Artist	7
Simone Renant	Rodeo clown	0
Alisa Freindlich	Artist	7
George Levendis	Rodeo clown	0
Kira Golovko	Artist	7
Neisha Bernard-Thomas	Rodeo clown	0
Abbas Mirza Sharifzadeh	Artist	7
Mateusz Sawrymowicz	Rodeo clown	0
Marisa Guterman	Artist	7
Ana Cláudia Lemos	Rodeo clown	0
Yanick Paquette	Artist	7
Lubomira Bacheva	Rodeo clown	0
Christine Borland	Artist	7
Al D'Amato	Playback Singer	0
Leon Kuhn	Artist	7
Joe Campbell (golfer)	Playback Singer	0
Michael Ray Bower	Artist	7
K. Shankar	Playback Singer	0
Azat Abbasov	Artist	7
Dale Hatcher	Playback Singer	0
Irina Baldina	Artist	7
Henri Marchand (actor)	Playback Singer	0
Yury Alexandrovich Kuznetsov	Artist	7
Ron Rodecker	Playback Singer	0
Thomas Langmann	Artist	7
Patricia Tarabini	Playback Singer	0
Vladimir Etush	Artist	7
Eddie Ainsmith	Playback Singer	0
Flora Karimova	Artist	7
Jamie Redfern	Playback Singer	0
Iryna Bilyk	Artist	7
David Lynn Jones	Playback Singer	0
Yuri Sergeevich Lavrov	Artist	7
Pedro Isidro	Bodybuilder	0
Jon Gnagy	Artist	7
Michelle Ashford	Bodybuilder	0
Grigori Aleksandrov	Artist	7
Niall of the Nine Hostages	Bodybuilder	0
Volodymyr Yurchyshyn	Artist	7
Ray Burdis	Bodybuilder	0
Ayame Koike	Artist	7
Emilio Villoresi	Bodybuilder	0
Spartak Mishulin	Artist	7
Edna May	Bodybuilder	0
Viktor Avdyushko	Artist	7
Bob Vail	Bodybuilder	0
Claes Elefalk	Artist	7
Gaurav Dhillon	Bodybuilder	0
Ellis Rabb	Artist	7
Ōki Takatō	Bodybuilder	0
Baby Niveditha	Artist	7
Michael Butler (computer scientist)	Bodybuilder	0
Eddie Shack	Entertainer	7
Peter Viereck	Astrologer	0
Yashwant Sardeshpande	Entertainer	7
Naveen Andrews	Astrologer	0
Pierre Bayle	Critic	7
Aleksei Shein	Astrologer	0
Ayub Khan-Din	Critic	7
Barney Schreiber	Astrologer	0
Jonathan Jakubowicz	Critic	7
Henry Davies (journalist)	Astrologer	0
Amara Miller	Critic	7
Juan de la Fuente	Astrologer	0
Darin Strauss	Critic	7
Isidora Bjelica	Astrologer	0
Nancy Snyder	Critic	7
Gennadi Sarafanov	Astrologer	0
Aubrey Levin	Physician	7
Obadiah	Astrologer	0
Arthur Henry Douthwaite	Physician	7
Pierre-Laurent Aimard	Astrologer	0
Herwin Novianto	Film Director	7
Erica Rhodes	Conductor	0
Mahmoud Shoolizadeh	Film Director	7
Louis Armstrong	Conductor	0
Vasu Varma	Film Director	7
Joe Mahr	Conductor	0
Ursula Meier	Film Director	7
Joseph F. Toomy	Conductor	0
Carl Woebcken	Film Director	7
Víctor Sánchez Mata	Conductor	0
Shari Robertson	Film Director	7
Henri d'Ursel	Conductor	0
David Oliveras	Film Director	7
Melchior Cibinensis	Conductor	0
John Swasey	Film Director	7
Trace Cyrus	Conductor	0
Grant Rosenberg	Science writer	7
Elvis Abbruscato	Conductor	0
Earl Kemp	Science writer	7
Bruce Cowan	Conductor	0
Les Guthman	Science writer	7
T. J. Anderson	Bishop	0
Elliott Kalan	Science writer	7
John Enderby	Bishop	0
Bridget Jones Nelson	Science writer	7
Ellis Gardner	Bishop	0
Volodymyr Ivanovych Barvinok	Science writer	7
Richard Sainct	Bishop	0
Linnea Sinclair	Science writer	7
Annette Daniels	Bishop	0
Gareth Parrington	Soldier	7
Randoll Coate	Bishop	0
Emma Cleasby	Soldier	7
Sean May	Bishop	0
Richard Wiley	Soldier	7
Sheena M. Joyce	Bishop	0
Sebastian Stan	Soldier	7
Charlotte Scott	Bishop	0
Annabelle Apsion	Soldier	7
Royle Stillman	Bishop	0
Ben Nealon	Soldier	7
LeRoy Stumpf	Book editor	0
Heikki Savolainen (actor)	Soldier	7
Yoshio Shirai	Book editor	0
Philip Bowen	Soldier	7
Jean de Brabant	Book editor	0
Ed Neumeister	Composer	7
Kelly Junge, Jr.	Book editor	0
Krzysztof Meyer	Composer	7
Antonio D'Amico	Book editor	0
Eduardo Espinoza	Mathematician	7
ICS Vortex	Book editor	0
Charalambos D. Aliprantis	Mathematician	7
Lars Hedlund	Book editor	0
Oliver Gavin	Racing driver	7
Ann Shipley	Book editor	0
Geoff Boss	Racing driver	7
Taku Takahashi	Book editor	0
Phil Parsons	Racing driver	7
Al Clauss	Book editor	0
Dan Clarke	Racing driver	7
Brad R. Torgersen	Sailor	0
Kamui Kobayashi	Racing driver	7
Harvey Hicks	Sailor	0
Robby Unser	Racing driver	7
Edward Lucas (congressman)	Sailor	0
Jimmy Vasser	Racing driver	7
Michael Kohn	Sailor	0
Daniel Ricciardo	Racing driver	7
Nikola Simić (actor)	Sailor	0
Steve Dance	Racing driver	7
Cynthia Enloe	Sailor	0
Cory Witherill	Racing driver	7
W. Wesley Peterson	Sailor	0
Jake Hill	Racing driver	7
Arthur Louis Aaron	Sailor	0
Tsuyoshi Tezuka	Racing driver	7
Andraes Norford	Sailor	0
Jim Guthrie (racing driver)	Racing driver	7
G. V. Harsha Kumar	Sailor	0
Mike Dillon (racing driver)	Racing driver	7
Michel Vennat	Athlete	0
Nic Grindrod	Racing driver	7
Hippolyte Girardot	Athlete	0
Sean Jones (ice hockey)	Ice hockey player	7
Chuck McElroy	Athlete	0
John Kennedy (musician)	Conductor	7
Cornbread Harris	Athlete	0
Thomas Wolsey	Bishop	7
Colin Booth	Athlete	0
Janus Pannonius	Bishop	7
Jonathan Ligali	Athlete	0
Scott J. Jones	Bishop	7
David Wise (freestyle skier)	Athlete	0
William Russell (bishop of North China)	Bishop	7
Sam Milby	Athlete	0
Paul Epworth	Bishop	7
Margarete Steiff	Athlete	0
Charles Francis Bishop	Bishop	7
Matt Viney	Athlete	0
Arbeo of Freising	Bishop	7
Rocco Papaleo	Sound Sculptor	0
Edwin Edgar Voigt	Bishop	7
Sasha Paysinger	Sound Sculptor	0
Jashwant Rao Chitambar	Bishop	7
Clara Beyers	Sound Sculptor	0
Gordon Strutt	Bishop	7
Toby Morris	Sound Sculptor	0
St John Evans	Bishop	7
Josu Ortuondo Larrea	Sound Sculptor	0
Thomas Smith (bishop of Carlisle)	Bishop	7
Chalom Messas	Sound Sculptor	0
Agustin Roman	Bishop	7
Kris Noble	Sound Sculptor	0
George (Schaefer)	Bishop	7
Kevin Casha	Sound Sculptor	0
Linus Parker	Bishop	7
Russell Thorson	Sound Sculptor	0
Josh Kelley	Bishop	7
Robert Gonera	Sound Sculptor	0
George Hose	Bishop	7
Frank Underhill	Jazz Composer	0
James Cowan (bishop)	Bishop	7
Marco Antonio Palacios	Jazz Composer	0
Michael Bishop, Baron Glendonbrook	Bishop	7
Johan A. Andersson	Jazz Composer	0
Bishop Dolegiewicz	Bishop	7
Verrier Elwin	Jazz Composer	0
Jonah of Hankou	Bishop	7
Fraser Brown (rugby union)	Jazz Composer	0
Federico Wanga	Bishop	7
Walter Rehberg	Jazz Composer	0
Francis Johnston (bishop)	Bishop	7
Allyn Cox	Jazz Composer	0
Kelly Bishop	Bishop	7
Carrie Southworth	Jazz Composer	0
Arculf	Bishop	7
Madeleine Thien	Jazz Composer	0
Vincent Joseph Hines	Bishop	7
David Coleman (architect)	Jazz Composer	0
Greg Bishop	Bishop	7
Buddhapālita	Publisher	0
Thomas Wood (bishop of Bedford)	Bishop	7
Pierre Louki	Publisher	0
Pat Bishop	Bishop	7
Eric Lander	Publisher	0
Richard Clitherow (bishop)	Bishop	7
Joe Caravello	Publisher	0
Tony Tremlett (bishop)	Bishop	7
Bob Zmuda	Publisher	0
Jeremiah Bishop	Bishop	7
Domingo González Pérez	Publisher	0
Henry de Sully (abbot)	Bishop	7
Aritha Van Herk	Publisher	0
William of Auvergne (bishop)	Bishop	7
David Dortort	Publisher	0
Archibald Cullen	Bishop	7
Joseph Attles	Publisher	0
Mike Colter	Bishop	7
Yamilka Noa	Publisher	0
Barry Bishop (mountaineer)	Bishop	7
Celia Lovsky	Spokesperson	0
Helen Goodman	Bishop	7
Massimiliano Blardone	Spokesperson	0
William Wilson Cash	Bishop	7
Ed Byrne (comedian)	Spokesperson	0
Edsel Albert Ammons	Bishop	7
Friedrich Gottfried Abel	Spokesperson	0
Cyril Asquith, Baron Asquith of Bishopstone	Bishop	7
Rui Miguel Rodrigues	Spokesperson	0
Haito	Bishop	7
Charles Wheelan	Spokesperson	0
John Wu	Bishop	7
Yakov Bulgakov	Spokesperson	0
Walter Hamilton (bishop)	Bishop	7
Darrel Chaney	Spokesperson	0
Daniel Mageean	Bishop	7
Sarah Badel	Spokesperson	0
Paul Francis Tanner	Bishop	7
Damir Keretić	Spokesperson	0
Benoit Groulx	Bishop	7
Miguel de Oliveira	Engineer	0
Charlie Bishop (baseball)	Bishop	7
Andrew Kuan	Engineer	0
John Moore (bishop of St Augustine)	Bishop	7
Anatol Kagan	Engineer	0
Mark Green (bishop)	Bishop	7
Alpha Kanu	Engineer	0
Reginald Heber	Bishop	7
Lisa Bund	Engineer	0
William Fleetwood	Bishop	7
Fred Stolle	Engineer	0
William Havard	Bishop	7
Don Wittman	Engineer	0
Thomas Brigham Bishop	Bishop	7
Sonny Angara	Engineer	0
Hae Jong Kim	Bishop	7
Humphrey Dixon	Engineer	0
Cortlandt F. Bishop	Bishop	7
Fred Gage	Engineer	0
Gasparo Contarini	Bishop	7
Les Earnest	Legislator	0
Ross Lewis	Bishop	7
Tetsuo Saito	Legislator	0
Georg von Blumenthal	Bishop	7
Tim Holt (statistician)	Legislator	0
Monica Collingwood	Bishop	7
Mary Loos	Legislator	0
John Chisholm (archbishop of Melanesia)	Bishop	7
Fanny Davies	Legislator	0
Hazen Graff Werner	Bishop	7
Justin Warren	Legislator	0
Otto Penzler	Book editor	7
Manfred Stefes	Legislator	0
Ruth Cavin	Book editor	7
Rick Hansen (Minnesota politician)	Legislator	0
Harvey Breit	Book editor	7
Hermann Löns	Legislator	0
David Carol	Book editor	7
Henry English Read	Legislator	0
Anne Ridler	Book editor	7
Kakaev Yakshigeldy	Missionary	0
Oskar Lebeck	Book editor	7
Nicole Cutler	Missionary	0
Jeremy Scahill	Book editor	7
Norman England (director)	Missionary	0
Joel Newkirk	Sailor	7
Chris Horton	Missionary	0
Susan Roman	Sailor	7
Lyle Neff	Missionary	0
Tiana Ringer	Athlete	7
David Collings	Missionary	0
Mathias Döpfner	Publisher	7
Nikolai Pozdneev	Missionary	0
Jamie Byng	Publisher	7
Ben Nolan	Missionary	0
Sally Hamwee, Baroness Hamwee	Spokesperson	7
Bucky Covington	Missionary	0
Avi Benayahu	Spokesperson	7
Yoyoy Villame	Missionary	0
Tracy Price-Thompson	Engineer	7
Ozan İpek	Harpsichordist	0
Stefan Eichinger	Engineer	7
Róisín Shortall	Harpsichordist	0
Trausti Valsson	Engineer	7
Gajo Petrović	Harpsichordist	0
William Carron, Baron Carron	Engineer	7
Owen Bennett-Jones	Harpsichordist	0
Silvio Micali	Engineer	7
Suresh Krishna (actor)	Harpsichordist	0
George Ivatt	Engineer	7
Leonid Bazan	Harpsichordist	0
Donald Welbourn	Engineer	7
Zofia Grabczan	Harpsichordist	0
William Kelly Wallace	Engineer	7
Dawson Simpson	Harpsichordist	0
Fred T. Perris	Engineer	7
Ray Hnatyshyn	Harpsichordist	0
Zhang Guangdou	Engineer	7
Ben Mansfield	Harpsichordist	0
Manindra Agrawal	Engineer	7
Roland Fraïssé	Rabbi	0
Clarence Hugo Linder	Engineer	7
Seaton McLean	Rabbi	0
Torsten Suel	Engineer	7
Pippin Parker	Rabbi	0
William Stanier	Engineer	7
Kirsten Rolffes	Rabbi	0
Ahmed Latif	Engineer	7
John Kern (Canadian politician)	Rabbi	0
Alexander Hrennikoff	Engineer	7
Lidija Bajuk	Rabbi	0
Charles Collett	Engineer	7
E. W. Hammons	Rabbi	0
Satyendra Dubey	Engineer	7
John Rickards (author)	Rabbi	0
Oliver Bulleid	Engineer	7
Joël Camathias	Rabbi	0
Wang Yongzhi	Engineer	7
Mark Hadfield	Rabbi	0
Liu Gaolian	Engineer	7
Grant Wilson	Singer	0
Charles Foulkes (British Army officer)	Engineer	7
Kenneth Cook	Singer	0
Gustaf Douglas	Engineer	7
Ken Takakura	Singer	0
Frederick Nelson	Engineer	7
Taribo West	Singer	0
Evert Hoek	Engineer	7
Hal Stalmaster	Singer	0
Laszlo B. Kish	Engineer	7
Joe Arenas	Singer	0
Thomas Christian Kavanagh	Engineer	7
Klaudia Schifferle	Singer	0
Misha Mahowald	Engineer	7
Luka Rupnik	Singer	0
John Findley Wallace	Engineer	7
Felix Kracht	Singer	0
Antoine Marc Gaudin	Engineer	7
King Sunny Adé	Singer	0
Scott Anderson (physicist)	Engineer	7
Leroy Cronin	Lyricist	0
Elton Younger	Engineer	7
Eve Mauro	Lyricist	0
Justin Cook	Engineer	7
William A. Caldwell	Lyricist	0
William Hammond Hall	Engineer	7
Henry Mercedes	Lyricist	0
Mervin Vavasour	Engineer	7
Mohinder Lal	Lyricist	0
Paul Morgan (engineer)	Engineer	7
Peter Hennessy	Lyricist	0
Mohammed Ghanbari	Engineer	7
Roger Poidatz	Lyricist	0
Karl Imhoff	Engineer	7
Phobay Kutu-Akoi	Lyricist	0
David Roberts (engineer)	Engineer	7
William Church (inventor)	Lyricist	0
Mohamed Yousef Soliman	Engineer	7
Norbert Putnam	Lyricist	0
William H.C. Whiting	Engineer	7
Bhartruhari Mahtab	Farmer	0
Jesse Hartley	Engineer	7
Leo Alexander	Farmer	0
Jan Potocki	Engineer	7
Nirmal Pandey	Farmer	0
Edwin Clark (civil engineer)	Engineer	7
Jozef Schell	Farmer	0
Nathan M. Newmark	Engineer	7
Thābit ibn Qurra	Farmer	0
Mark Whitby	Engineer	7
Denzil Batchelor	Farmer	0
Ricardo Montano	Legislator	7
Melanie Schultz van Haegen	Farmer	0
David Livingstone	Missionary	7
Gabriel J. Chin	Farmer	0
Thomas Powell (botanist)	Missionary	7
Lana Coc-Kroft	Farmer	0
Alexander Stronach	Missionary	7
Nikko Smith	Farmer	0
John Ince (missionary)	Missionary	7
Gowin Knight	Editor	0
Thomas Beighton	Missionary	7
Mark Imgrund	Editor	0
Alexander Williamson (missionary)	Missionary	7
James Chambers (politician)	Editor	0
Bento de Góis	Missionary	7
Veniero Colasanti	Editor	0
William Anderson (missionary)	Missionary	7
Dion Dreesens	Editor	0
Pinchas Goldschmidt	Rabbi	7
Jorge Guinzburg	Editor	0
Rabbie Namaliu	Rabbi	7
Anthony Brady	Editor	0
Hyman Chanover	Rabbi	7
Ruth de Souza	Editor	0
Shmuel Schneersohn	Rabbi	7
Dontari Poe	Editor	0
Junius Matthews	Rabbi	7
Robert Ross (entrepreneur)	Editor	0
Louis Werfel	Rabbi	7
Hirohiko Nakamura	Film critic	0
Aatsista-Mahkan	Rabbi	7
Adam Dutkiewicz	Film critic	0
Wayne Bartholomew	Rabbi	7
Christina Strain	Film critic	0
Nachum Shifren	Rabbi	7
Christian Ribeiro	Film critic	0
Hershel Schachter	Rabbi	7
Fred Talley	Film critic	0
Samuel Judah Katzenellenbogen	Rabbi	7
Kyle Reynish	Film critic	0
Yitzchak Dovid Grossman	Rabbi	7
John Conrad Otto	Film critic	0
Walter Wurzburger	Rabbi	7
Mark Brydon	Film critic	0
Jill Jacobs (rabbi)	Rabbi	7
David du Bose Gaillard	Film critic	0
Bernard M. Casper	Rabbi	7
Mark Minichiello	Film critic	0
Scott Geddes	Rabbi	7
James Gregory (mathematician)	Jazz Pianist	0
Sholom Klass	Rabbi	7
Chris Broussard	Jazz Pianist	0
David Tyrrell (rugby league)	Rabbi	7
Terrence Malick	Jazz Pianist	0
Aharon Feldman	Rabbi	7
Joseph Cahill	Jazz Pianist	0
Haninah ben Teradion	Rabbi	7
Katy Murphy	Jazz Pianist	0
David Penna	Rabbi	7
Mia Hansen-Løve	Jazz Pianist	0
Selig Starr	Rabbi	7
Nabil Shaban	Jazz Pianist	0
Shalom Dov Wolpo	Rabbi	7
Ian McIntosh	Jazz Pianist	0
Akiva Eger	Rabbi	7
Bruno Prevedi	Jazz Pianist	0
Ovadia Yosef	Rabbi	7
Joseph Lelyveld	Jazz Pianist	0
Isidore Epstein	Rabbi	7
George Howard, 7th Earl of Carlisle	Politician	0
Rebecca Alpert	Rabbi	7
Tom Bellchambers	Politician	0
Naamah Kelman	Rabbi	7
A. Lee Martinez	Politician	0
Elyse Goldstein	Rabbi	7
Richard Bass	Politician	0
Moshe Shmuel Glasner	Rabbi	7
Marga van Praag	Politician	0
Eddie Rabbitt	Rabbi	7
Irma P. Hall	Politician	0
Werner van der Zyl	Rabbi	7
Steve A. Matthews	Politician	0
Raphael Berdugo	Rabbi	7
William Ramsey (architect)	Politician	0
Israel Brodie	Rabbi	7
Coco Rocha	Politician	0
Baba Sali	Rabbi	7
David Abbott (magician)	Politician	0
Raphael Meldola (Sephardic Rabbi)	Rabbi	7
Dave Short	Baseball Manager	0
Moses ibn Ezra	Rabbi	7
Arnold Jackson (British Army officer)	Baseball Manager	0
Brian Kennedy (journalist)	Singer	7
Joseph Amenowode	Baseball Manager	0
Simphiwe Dana	Singer	7
Vladimir Lavrinenko	Baseball Manager	0
Richard Singer	Singer	7
Ruby Moreno	Baseball Manager	0
Franz Wasner	Singer	7
Arnold Harrison	Baseball Manager	0
Bob Singer	Singer	7
Carolina Soto Losada	Baseball Manager	0
Isaac Bashevis Singer	Singer	7
Bart Willoughby	Baseball Manager	0
Hal Singer	Singer	7
Shinobu Sato	Baseball Manager	0
Cecilia Beaux	Singer	7
Ed Comeau	Baseball Manager	0
Washington Singer	Singer	7
Jude Kuring	Social activist	0
Eric Singer	Singer	7
Daniel Gutstein	Social activist	0
Tommy Singer	Singer	7
Michael Croft	Social activist	0
Clara Ward	Singer	7
Duke Snider	Social activist	0
Ernő Gerő	Singer	7
Nauheed Cyrusi	Social activist	0
Robert L. Doughton	Farmer	7
Joseph Moxon	Social activist	0
Lars Sverkeson Romundstad	Farmer	7
Levi Boone	Social activist	0
Laurent Boutonnat	Farmer	7
Christine Vachon	Social activist	0
Todd Farmer	Farmer	7
Phillip McArthur	Social activist	0
Howard Farmer	Farmer	7
Ben Chandler	Social activist	0
Henry Plumb, Baron Plumb	Farmer	7
John Lenczowski	Civil servant	0
Alex Farmer	Farmer	7
Garo Aida	Civil servant	0
Stian Carstensen	Farmer	7
Philip Bourneuf	Civil servant	0
Larry Farmer (basketball)	Farmer	7
Ned Balbo	Civil servant	0
Elmer Austin Benson	Farmer	7
Ana Karić	Civil servant	0
Nancy Farmer (politician)	Farmer	7
Otto Nathan	Civil servant	0
William Massey	Farmer	7
Victoria Lagerström	Civil servant	0
Elwyn Tinklenberg	Farmer	7
Larry Tanz	Civil servant	0
Red Farmer	Farmer	7
Gordon H. Bower	Civil servant	0
Gavin Hewitt	Editor	7
Fred Ewing Lewis	Civil servant	0
Jamie Drummond	Editor	7
Plamen Nikolov (footballer, born 1985)	Author	0
Vahan Janjigian	Editor	7
Fred Goldsmith (American football)	Author	0
Senan Molony	Editor	7
Enrico Berlinguer	Author	0
Maurizio Molinari	Editor	7
Alix Smith	Author	0
John Moody (journalist)	Editor	7
Lokesh	Author	0
MaryAnne Golon	Editor	7
Cindy Robbins	Author	0
Sirajul Islam	Editor	7
Gavriil Ilizarov	Author	0
Watson Heston	Editor	7
Jerramy Stevens	Author	0
Charles Wintour	Editor	7
Marcus Randall	Author	0
Faisal Islam	Editor	7
Andy O'Connor	Author	0
John Pienaar	Editor	7
Maximilian Arnold	Investor	0
Soliman Kenawy	Editor	7
Attahiru Bafarawa	Investor	0
Sam Sifton	Editor	7
Marguerite de Navarre	Investor	0
Charlotte Eagar	Editor	7
Ralph W. Gerard	Investor	0
Francisco Cimadevilla	Editor	7
Zip Zabel	Investor	0
Axel Alonso	Editor	7
Robert L. Bernstein	Investor	0
Lucy Yeomans	Editor	7
Malcolm Marshall	Investor	0
Raj Kamal Jha	Editor	7
Arlas Taylor	Investor	0
Amir Mizroch	Editor	7
Luke Whisnant	Investor	0
Sam Dealey	Editor	7
Jack Birkett	Investor	0
Georgy Golitsyn	Editor	7
Wilma Lee Cooper	Art Director	0
Uttam Kamble	Editor	7
Clinton Ford (singer)	Art Director	0
George Poveromo	Editor	7
Don G. Despain	Art Director	0
Rob Boston	Editor	7
Charles-Louis Clérisseau	Art Director	0
Geoffrey Hill	Editor	7
Richard De Angelis	Art Director	0
Graham Dudman	Editor	7
Rasuna Said	Art Director	0
Dann Cahn	Editor	7
Robert B. Doyle	Art Director	0
Adam Boulton	Editor	7
Undra Johnson	Art Director	0
Russell Leetch	Editor	7
Val Heim	Art Director	0
Taaha Shah	Film critic	7
Nils Holm (film editor)	Art Director	0
Emanuel Levy	Film critic	7
Zoltán Gera	Showgirl	0
Mullappally Ramachandran	Politician	7
James D. Meindl	Showgirl	0
Clemens Schmalstich	Politician	7
Charles E. Freeman	Showgirl	0
Prafulla Kumar Mahanta	Politician	7
Milan Rodić	Showgirl	0
Edward Osóbka-Morawski	Social activist	7
Todhunter Ballard	Showgirl	0
Symon Hill	Social activist	7
Eva-Maria Hagen	Showgirl	0
Leung Kwok-hung	Social activist	7
Harlan Hubbard	Showgirl	0
Billy Wharton	Social activist	7
Shania Twain	Showgirl	0
Clara Jusidman	Social activist	7
Charles Sibanda	Showgirl	0
Wacław Sieroszewski	Social activist	7
Anders Lindegaard	Showgirl	0
Ian Watmore	Civil servant	7
Sérgio Conceição	Peace activist	0
Kathy Orr (meteorologist)	Author	7
Walter Tappan	Peace activist	0
Marc Ostrofsky	Author	7
James William Bryan	Peace activist	0
Jonathan Rigby	Author	7
Eduard Albert	Peace activist	0
William Morris Colles	Author	7
Joe Wallis	Peace activist	0
Adnan al-Husayni	Author	7
Oretta Fiume	Peace activist	0
Paolo Costa	Author	7
Arthur Legat	Peace activist	0
Neil David Levin	Author	7
Alexander Mackenzie	Peace activist	0
Qadura Fares	Author	7
Diederik Durven	Peace activist	0
Maggie O'Farrell	Author	7
William S. Rukeyser	Peace activist	0
Andry Rajoelina	Author	7
Gideon Reynolds	Curator	0
Joudeh George Murqos	Author	7
Fritz Gerlich	Curator	0
Nasser al-Shaer	Author	7
Therese Svendsen	Curator	0
Mahmoud Aloul	Author	7
David Zurutuza	Curator	0
John Cogliano	Author	7
Joyce Carol Thomas	Curator	0
David Flint	Author	7
Lauren Vélez	Curator	0
Walter B. Slocombe	Author	7
Sascha Riether	Curator	0
Ralph V Whitworth	Investor	7
Anthony Lombard	Curator	0
Petter Stordalen	Investor	7
François Baroin	Curator	0
Austin Tate	Art Director	7
Thomas Chaloner (statesman)	Curator	0
Rosemary Thompson	Art Director	7
James Shirley	Comedian	0
Michael Palliser	Art Director	7
Bob Keating	Comedian	0
Chris DeRose	Peace activist	7
Ronald D. Moore	Comedian	0
Tom Fox (Quaker)	Peace activist	7
Tommy Bowe	Comedian	0
Jestina Mukoko	Peace activist	7
Paul Devorski	Comedian	0
Tom Hayden	Peace activist	7
Bettina May	Comedian	0
Scott Hocknull	Curator	7
Adrian Sitaru	Comedian	0
Bruce Guenther	Curator	7
Bonnie St. John	Comedian	0
Virginia Mecklenburg	Curator	7
Thomas Coville	Comedian	0
Ravi Baswani	Comedian	7
Eddie Argos	Comedian	0
Diego Llorico	Comedian	7
Luka Pejović	Architect	0
Gabrielle Dennis	Comedian	7
Alexander Kharlamov	Architect	0
Malcolm Holzman	Architect	7
Brian Colon	Architect	0
Hani Rashid	Architect	7
Paul Epstein	Architect	0
Glenn Murcutt	Architect	7
Haidar Abu Bakr al-Attas	Architect	0
Thom Nickels	Architect	7
Dummy Leitner	Architect	0
Louis A. McMillen	Architect	7
Andy Connell	Architect	0
Aarno Ruusuvuori	Architect	7
Jim Minshall	Architect	0
George Phillips Manners	Architect	7
Mike Oxley	Architect	0
B. Stanley Simmons	Architect	7
Zoran Stanković	Architect	0
Julien De Smedt	Architect	7
Sean Reinert	Game Show Host	0
John William Simpson	Architect	7
Jerry Sanders (politician)	Game Show Host	0
Pavel Suzor	Architect	7
Rachilde	Game Show Host	0
John George Knight	Architect	7
Sayed Badreya	Game Show Host	0
Arthur D. Gilman	Architect	7
Patrick Crank	Game Show Host	0
Martino Ferabosco	Architect	7
Traisy Vivien Tukiet	Game Show Host	0
Sharon Rotbard	Architect	7
Stephan Rössner	Game Show Host	0
Alejandro Zaera-Polo	Architect	7
Ricky Bruch	Game Show Host	0
Peter Walker (landscape architect)	Architect	7
Andreas Beck (footballer)	Game Show Host	0
Schuermann	Architect	7
Sam Ernst	Game Show Host	0
George Allen Mansfield	Architect	7
Isaias W. Hellman	Military Officer	0
Clyde Markwell	Architect	7
Lorri Neilsen Glenn	Military Officer	0
Nabil Gholam	Architect	7
Jesse Lynch Williams	Military Officer	0
Krishnarao Jaisim	Architect	7
Yahoo Serious	Military Officer	0
Paul Rudolph (architect)	Architect	7
Amarachi Obiajunwa	Military Officer	0
Hugo Eberhardt	Architect	7
Mario G. Pino	Military Officer	0
Michael Middleton Dwyer	Architect	7
Domenico Mazzocchi	Military Officer	0
Gwyn Jay Allen	Architect	7
Lucille Roybal-Allard	Military Officer	0
Gustavo Rangel Briceño	Military Officer	7
Adriano Moraes	Military Officer	0
Robert Nairac	Military Officer	7
Ants Antson	Military Officer	0
